The Beach
An Interactive Fiction
Release 1 / Serial number 210310 / Inform 7 build 6M62 (I6/v6.34 lib 6/12N) SD

Beach
You're on a muddy beach at low tide. There are probably oysters under the mud.

You can see several oysters and a funny tool here.

>actions
Actions listing on.

>take tool
[taking the funny tool]
Taken.
[taking the funny tool - succeeded]

>take oyster
[taking several oysters]
You dig in the mud and come up with an oyster.
[taking several oysters - succeeded]

>i
[taking inventory]
You are carrying:
  an oyster (closed)
  a funny tool

[taking inventory - succeeded]

>open oyster with tool
[unlocking the oyster with the funny tool]
[(1) examining the funny tool]
The tool has a rubber handle and a wide, flat, rounded blade.

Aha! It's an oyster knife.
[(1) examining the oyster knife - succeeded]

[(1) opening the oyster]
You work the blade of the oyster knife carefully into the corner of the oyster and twist until it pops open.
[(1) opening the oyster - succeeded]

[unlocking the oyster with the oyster knife - succeeded]

>open oyster with tool
[unlocking the oyster with the oyster knife]
[(1) examining the oyster knife]
It's an oyster knife.

Aha! It's an oyster knife.
[(1) examining the oyster knife - succeeded]

[(1) opening the oyster]
It's already open!
[(1) opening the oyster - failed]

[unlocking the oyster with the oyster knife - succeeded]

* * *

The Beach
An Interactive Fiction
Release 1 / Serial number 210310 / Inform 7 build 6M62 (I6/v6.34 lib 6/12N) SD

Beach
You're on a muddy beach at low tide. There are probably oysters under the mud.

You can see several oysters and a funny tool here.

>get oyster
You dig in the mud and come up with an oyster.

[Your score has just gone up by one point.]

>eat oyster
You need to open the oyster first.

>open oyster
It's closed tightly. You need to find something you can use to to open it.

>eat oyster
You need to open the oyster first.

>i
You are carrying:
  an oyster (closed)

>look
Beach
You're on a muddy beach at low tide. There are probably oysters under the mud.

You can see several oysters and a knife here.

>get oysters
You are already holding an oyster. You should probably do something with it first.

>i
You are carrying:
  an oyster (closed)

>get knife
Taken.

>open oyster
You work the knife blade carefully into the corner of the oyster and twist until it pops open.

>eat oyster
(the oyster)
You slurp down the oyster, and toss the shell away.

>i
You are carrying:
  a knife

* * *

>get oyster
You dig in the mud and come up with an oyster.

[Your score has just gone up by one point.]

>open oyster
It's closed tightly. You need to find something you can use to to open it.

>get knife
Taken.

* * *

>open oyster
You work the knife blade carefully into the corner of the oyster and twist until it pops open.

>x oyster
It's a rough, oblong, oyster shell, with a couple of barnacles attached and some specks of mud.

In the oyster are a pearl and a meat.

>x oyster body
I only understood you as far as wanting to examine the oyster.

>i
You are carrying:
  a knife
  an oyster (open)
    a pearl
    a meat

>get oyster
You already have that.

>x oyster
It's a rough, oblong, oyster shell, with a couple of barnacles attached and some specks of mud.

In the oyster are a pearl and a meat.

>open oyster
You work the knife blade carefully into the corner of the oyster and twist until it pops open.

>get oyster
You already have that.

>open oyster
You work the knife blade carefully into the corner of the oyster and twist until it pops open.

* * *

>get oyster
You dig in the mud and come up with an oyster.

[Your score has just gone up by one point.]

>take tool
Taken.

>open oyster with tool
The tool has a rubber handle and a wide, flat, rounded blade.

Aha! It's an oyster knife.

You work the blade of the oyster knife carefully into the corner of the oyster and twist until it pops open.

>eat oyster
You slurp down the contents of the oyster, and toss the shell away.

[Your score has just gone up by one point.]

* * *

>get oyster
You dig in the mud and come up with an oyster.

[Your score has just gone up by one point.]

>x oyster
It's a rough, oblong, oyster shell, with a couple of barnacles attached and some specks of mud.

>open oyster
It's closed tightly. You need to find something you can use to to open it.

* * *

>open oyster
You work the knife blade carefully into the corner of the oyster and twist until it pops open.

>x oyster
It's a rough, oblong, oyster shell, with a couple of barnacles attached and some specks of mud.

In the oyster is a meat.

* * *

The Beach
An Interactive Fiction
Release 1 / Serial number 210310 / Inform 7 build 6M62 (I6/v6.34 lib 6/12N) SD

Beach
You're on a muddy beach at low tide. There are probably oysters under the mud.

You can see several oysters and a funny tool here.

>get oysters
You dig up an oyster from the mud.

>eat oyster
You eat the oyster. Not bad.

>look
Beach
You can see an assortment of oysters here.

>get oyster
You dig up an oyster from the mud.

>get oyster
You already have that.

>i
You are carrying:
  an oyster

>eat oyster
You eat the oyster. Not bad.

>i
You are carrying nothing.

>look
Beach
You can see an assortment of oysters here.

>i
You are carrying nothing.

>take oyster
You dig up an oyster from the mud.

>take oyster
You already have that.

>take assortment
You are already holding an oyster. You should probably do something with it first.

* * *

>get oysters
You dig up an oyster from the mud.

>get oysters
You are already holding an oyster. You should probably do something with it first.

>get oyster
You already have that.

>x oyster
You see nothing special about the oyster.

>eat oyster
You eat the oyster. Not bad.

* * *

The Beach
An Interactive Fiction
Release 1 / Serial number 210310 / Inform 7 build 6M62 (I6/v6.34 lib 6/12N) SD

Beach
You're on a muddy beach at low tide. There are probably oysters under the mud.

You can see several oysters and a funny tool here.

>get tool
Taken.

>x tool
The tool has a rubber handle and a wide, flat, rounded blade.

>get oyster
You dig in the mud and come up with an oyster.

>open oyster
See if you can find something to open it with.

>x tool
It has a rubber handle and a wide, flat, rounded blade.

Aha! It's an oyster knife.

>i
You are carrying:
  an oyster (closed)
  an oyster knife

>open oyster
You work the blade carefully into the corner of the oyster and twist until it pops open.

>eat oyster
You slurp down the contents of the oyster, and toss the shell away.

>get oyster
You dig in the mud and come up with an oyster.

>i
You are carrying:
  an oyster (closed)
  an oyster knife

>eat oyster
You need to open the oyster first.

>open oyster
You work the blade carefully into the corner of the oyster and twist until it pops open.
To your surprise, there is a pearl glistening on top of the oyster body. You carefully pick it out.

>restart
Are you sure you want to restart?

>yes
Oysters
An Interactive Fiction
Release 1 / Serial number 210304 / Inform 7 build 6M62 (I6/v6.34 lib 6/12N) SD

Beach
You're on a muddy beach at low tide. There are probably oysters under the mud.

You can see several oysters and a funny tool here.

>get oyster
You dig in the mud and come up with an oyster.

>i
You are carrying:
  an oyster (closed)

>open oyster
See if you can find something to open it with.

>get tool
Taken.

>open oyster with tool
That doesn't seem to be something you can unlock.

* * *

>get oyster
You dig in the mud and come up with an oyster.

>x oyster
It's a rough, oblong, oyster shell, with a couple of barnacles attached and some specks of mud.

>x tool
The tool has a rubber handle and a wide, flat, rounded blade.

Aha! It's an oyster knife.

>open oyster with knife
You can't see any such thing.

>open oyster with oyster knife
It's an oyster knife.

Aha! It's an oyster knife.

You work the blade of the oyster knife carefully into the corner of the oyster and twist until it pops open.
To your surprise, there is a pearl glistening on top of the oyster body. You carefully pick it out.

>x pearl
It's a small pearl, not quite spherical, but it will make a nice memento. Maybe Mom will like it.

>i
You are carrying:
  a pearl
  an oyster (open)
    meat
  an oyster knife

>eat meat
You slurp down the contents of the oyster, and toss the shell away.

>i
You are carrying:
  a pearl
  an oyster knife

>get oyster
You dig in the mud and come up with an oyster.

>open oyster
You work the blade of the oyster knife carefully into the corner of the oyster and twist until it pops open.
To your surprise, there is a pearl glistening on top of the oyster body. You carefully pick it out.

>drop oyster
Dropped.

>look
Beach
You're on a muddy beach at low tide. There are probably oysters under the mud.

You can see an oyster (in which is meat) and several oysters here.

* * *

The Beach
An Interactive Fiction
Release 1 / Serial number 210310 / Inform 7 build 6M62 (I6/v6.34 lib 6/12N) SD

Beach
You're on a muddy beach at low tide. There are probably oysters under the mud.

You can see several oysters and a funny tool here.

>i
You are carrying:
  a Halloween bag
    four pieces of candy

>eat candy
(first taking the piece of candy)
You eat the piece of candy. Not bad.

>eat candy
(first taking the piece of candy)
You eat the piece of candy. Not bad.

>eat candy
(first taking the piece of candy)
Oh, that didn't taste right at all. Oh well!

>eat candy
(first taking the piece of candy)
You eat the piece of candy. Not bad.

* * *

The Beach
An Interactive Fiction
Release 1 / Serial number 210310 / Inform 7 build 6M62 (I6/v6.34 lib 6/12N) SD

Beach
You're on a muddy beach at low tide. There are probably oysters under the mud.

You can see several oysters and a funny tool here.

>rules
Rules tracing now switched on. Type "rules off" to switch it off again, or "rules all" to include even rules which do not apply.

>get oyster
[Rule "declare everything initially unmentioned rule" applies.]
[Rule "announce items from multiple object lists rule" applies.]
[Rule "set pronouns from items from multiple object lists rule" applies.]
[Rule "before stage rule" applies.]
[Rule "instead stage rule" applies.]
[Rule "taking oysters from mud rule" applies.]
You dig in the mud and come up with an oyster.

[Rule "announce items from multiple object lists rule" applies.]
[Rule "set pronouns from items from multiple object lists rule" applies.]
[Rule "before stage rule" applies.]
[Rule "instead stage rule" applies.]
[Rule "investigate player's awareness before action rule" applies.]
[Rule "player aware of his own actions rule" applies.]
[Rule "check stage rule" applies.]
[Rule "take oyster rule" applies.]
[Rule "can't take yourself rule" applies.]
[Rule "can't take other people rule" applies.]
[Rule "can't take component parts rule" applies.]
[Rule "can't take people's possessions rule" applies.]
[Rule "can't take items out of play rule" applies.]
[Rule "can't take what you're inside rule" applies.]
[Rule "can't take what's already taken rule" applies.]
[Rule "can't take scenery rule" applies.]
[Rule "can only take things rule" applies.]
[Rule "can't take what's fixed in place rule" applies.]
[Rule "use player's holdall to avoid exceeding carrying capacity rule" applies.]
[Rule "can't exceed carrying capacity rule" applies.]
[Rule "carry out stage rule" applies.]
[Rule "standard taking rule" applies.]
[Rule "after stage rule" applies.]
[Rule "after taking an oyster for the first time" applies.]
[Rule "A first turn sequence rule" applies.]
[Rule "every turn stage rule" applies.]
[Rule "A last turn sequence rule" applies.]
[Rule "notify score changes rule" applies.]
[Your score has just gone up by one point.]

* * *

>eat oyster
[Rule "declare everything initially unmentioned rule" applies.]
[Rule "announce items from multiple object lists rule" applies.]
[Rule "set pronouns from items from multiple object lists rule" applies.]
[Rule "before stage rule" applies.]
[Rule "instead stage rule" applies.]
[Rule "investigate player's awareness before action rule" applies.]
[Rule "player aware of his own actions rule" applies.]
[Rule "check stage rule" applies.]
[Rule "check before eating rule" applies.]
[Rule "can't eat unless edible rule" applies.]
[Rule "can't eat clothing without removing it first rule" applies.]
[Rule "can't eat other people's food rule" applies.]
[Rule "can't eat portable food without carrying it rule" applies.]
[Rule "carry out stage rule" applies.]
[Rule "eat oyster rule" applies.]
You slurp down the contents of the oyster, and toss the shell away.

[Rule "standard eating rule" applies.]
[Rule "after stage rule" applies.]
[Rule "after eating an oyster for the first time" applies.]
[Rule "A first turn sequence rule" applies.]
[Rule "every turn stage rule" applies.]
[Rule "A last turn sequence rule" applies.]
[Rule "notify score changes rule" applies.]
[Your score has just gone up by one point.]

* * *

The Beach
An Interactive Fiction
Release 1 / Serial number 210310 / Inform 7 build 6M62 (I6/v6.34 lib 6/12N) SD

Beach
You're on a muddy beach at low tide. There are probably oysters under the mud.

You can see several oysters and a funny tool here.

>showall
That's not a verb I recognise.

>showme oyster
oyster - closed container
location: out of play
singular-named, improper-named; unlit, inedible, portable; opaque, closed, openable, unlocked
list grouping key: none
printed name: "oyster"
printed plural name: "containers"
indefinite article: none
description: "It's a rough, oblong, oyster shell, with a couple of barnacles attached and some specks of mud."
initial appearance: none
carrying capacity: 100

>showme funny tool
funny tool - thing
location: in the Beach
singular-named, improper-named; unlit, inedible, portable
list grouping key: none
printed name: "funny tool"
printed plural name: none
indefinite article: none
description: "It has a rubber handle and a wide, flat, rounded blade."
initial appearance: none
identified: false

* * *

The Beach
An Interactive Fiction
Release 1 / Serial number 210310 / Inform 7 build 6M62 (I6/v6.34 lib 6/12N) SD

Beach
You're on a muddy beach at low tide. There are probably oysters under the mud.

You can see several oysters and a funny tool here.

>take oyster
You dig in the mud and come up with an oyster.

[Your score has just gone up by one point.]

>i
You are carrying:
  an oyster (closed)

>eat oyster
You need to open the oyster first.

>open oyster with tool
(first taking the funny tool)
The tool has a rubber handle and a wide, flat, rounded blade.

Aha! It's an oyster knife.

You work the blade of the oyster knife carefully into the corner of the oyster and twist until it pops open.

>eat oyster
You slurp down the contents of the oyster, and toss the shell away.

You eat the oyster. Not bad.

>take oyster
You dig in the mud and come up with an oyster.

Taken.

>drop oyster
Dropped.

>take oyster
Taken.

>take oyster
You already have one!

>actions
Actions listing on.

>eat oyster
[eating the oyster]
You need to open the oyster first.
[eating the oyster - failed the check before eating rule]

>open oyster
[opening the oyster]

You work the blade of the oyster knife carefully into the corner of the oyster and twist until it pops open.
[opening the oyster - succeeded]

>eat oyster
[eating the oyster]
You slurp down the contents of the oyster, and toss the shell away.

You eat the oyster. Not bad.
[eating the oyster - succeeded]

>rules
Rules tracing now switched on. Type "rules off" to switch it off again, or "rules all" to include even rules which do not apply.

>get oyster
[Rule "declare everything initially unmentioned rule" applies.]
[taking several oysters]
[Rule "announce items from multiple object lists rule" applies.]
[Rule "set pronouns from items from multiple object lists rule" applies.]
[Rule "before stage rule" applies.]
[Rule "instead stage rule" applies.]
[Rule "taking oysters from mud rule" applies.]
You dig in the mud and come up with an oyster.

[(1) taking the oyster]
[Rule "announce items from multiple object lists rule" applies.]
[Rule "set pronouns from items from multiple object lists rule" applies.]
[Rule "before stage rule" applies.]
[Rule "instead stage rule" applies.]
[Rule "investigate player's awareness before action rule" applies.]
[Rule "player aware of his own actions rule" applies.]
[Rule "check stage rule" applies.]
[Rule "take oyster rule" applies.]
[Rule "can't take yourself rule" applies.]
[Rule "can't take other people rule" applies.]
[Rule "can't take component parts rule" applies.]
[Rule "can't take people's possessions rule" applies.]
[Rule "can't take items out of play rule" applies.]
[Rule "can't take what you're inside rule" applies.]
[Rule "can't take what's already taken rule" applies.]
[Rule "can't take scenery rule" applies.]
[Rule "can only take things rule" applies.]
[Rule "can't take what's fixed in place rule" applies.]
[Rule "use player's holdall to avoid exceeding carrying capacity rule" applies.]
[Rule "can't exceed carrying capacity rule" applies.]
[Rule "carry out stage rule" applies.]
[Rule "standard taking rule" applies.]
[Rule "after stage rule" applies.]
[Rule "investigate player's awareness after action rule" applies.]
[Rule "report stage rule" applies.]
[Rule "standard report taking rule" applies.]
Taken.
[Rule "last specific action-processing rule" applies.]
[(1) taking the oyster - succeeded]

[taking several oysters - succeeded]

[Rule "A first turn sequence rule" applies.]
[Rule "every turn stage rule" applies.]
[Rule "A last turn sequence rule" applies.]
[Rule "notify score changes rule" applies.]

>open oyster
[Rule "declare everything initially unmentioned rule" applies.]
[opening the oyster]
[Rule "announce items from multiple object lists rule" applies.]
[Rule "set pronouns from items from multiple object lists rule" applies.]
[Rule "before stage rule" applies.]
[Rule "instead stage rule" applies.]
[Rule "generic open oyster rule" applies.]

You work the blade of the oyster knife carefully into the corner of the oyster and twist until it pops open.

The oyster shell is full of mud! You toss it away in disgust. 

It's probably worth another try.
[opening the oyster - succeeded]

[Rule "A first turn sequence rule" applies.]
[Rule "every turn stage rule" applies.]
[Rule "A last turn sequence rule" applies.]
[Rule "notify score changes rule" applies.]

>get oyster
[Rule "declare everything initially unmentioned rule" applies.]
[taking several oysters]
[Rule "announce items from multiple object lists rule" applies.]
[Rule "set pronouns from items from multiple object lists rule" applies.]
[Rule "before stage rule" applies.]
[Rule "instead stage rule" applies.]
[Rule "taking oysters from mud rule" applies.]
You dig in the mud and come up with an oyster.

[(1) taking the oyster]
[Rule "announce items from multiple object lists rule" applies.]
[Rule "set pronouns from items from multiple object lists rule" applies.]
[Rule "before stage rule" applies.]
[Rule "instead stage rule" applies.]
[Rule "investigate player's awareness before action rule" applies.]
[Rule "player aware of his own actions rule" applies.]
[Rule "check stage rule" applies.]
[Rule "take oyster rule" applies.]
[Rule "can't take yourself rule" applies.]
[Rule "can't take other people rule" applies.]
[Rule "can't take component parts rule" applies.]
[Rule "can't take people's possessions rule" applies.]
[Rule "can't take items out of play rule" applies.]
[Rule "can't take what you're inside rule" applies.]
[Rule "can't take what's already taken rule" applies.]
[Rule "can't take scenery rule" applies.]
[Rule "can only take things rule" applies.]
[Rule "can't take what's fixed in place rule" applies.]
[Rule "use player's holdall to avoid exceeding carrying capacity rule" applies.]
[Rule "can't exceed carrying capacity rule" applies.]
[Rule "carry out stage rule" applies.]
[Rule "standard taking rule" applies.]
[Rule "after stage rule" applies.]
[Rule "investigate player's awareness after action rule" applies.]
[Rule "report stage rule" applies.]
[Rule "standard report taking rule" applies.]
Taken.
[Rule "last specific action-processing rule" applies.]
[(1) taking the oyster - succeeded]

[taking several oysters - succeeded]

[Rule "A first turn sequence rule" applies.]
[Rule "every turn stage rule" applies.]
[Rule "A last turn sequence rule" applies.]
[Rule "notify score changes rule" applies.]

>open oyster
[Rule "declare everything initially unmentioned rule" applies.]
[opening the oyster]
[Rule "announce items from multiple object lists rule" applies.]
[Rule "set pronouns from items from multiple object lists rule" applies.]
[Rule "before stage rule" applies.]
[Rule "instead stage rule" applies.]
[Rule "generic open oyster rule" applies.]

You work the blade of the oyster knife carefully into the corner of the oyster and twist until it pops open.

[(1) taking the pearl]
[Rule "announce items from multiple object lists rule" applies.]
[Rule "set pronouns from items from multiple object lists rule" applies.]
[Rule "before stage rule" applies.]
[Rule "instead stage rule" applies.]
[Rule "investigate player's awareness before action rule" applies.]
[Rule "player aware of his own actions rule" applies.]
[Rule "check stage rule" applies.]
[Rule "can't take yourself rule" applies.]
[Rule "can't take other people rule" applies.]
[Rule "can't take component parts rule" applies.]
[Rule "can't take people's possessions rule" applies.]
[Rule "can't take items out of play rule" applies.]
[Rule "can't take what you're inside rule" applies.]
[Rule "can't take what's already taken rule" applies.]
[Rule "can't take scenery rule" applies.]
[Rule "can only take things rule" applies.]
[Rule "can't take what's fixed in place rule" applies.]
[Rule "use player's holdall to avoid exceeding carrying capacity rule" applies.]
[Rule "can't exceed carrying capacity rule" applies.]
[Rule "carry out stage rule" applies.]
[Rule "standard taking rule" applies.]
[Rule "after stage rule" applies.]
[Rule "after taking a pearl" applies.]
I'm rich!
[(1) taking the pearl - succeeded]

To your surprise, there is a pearl glistening on top of the oyster meat. You carefully pick it out. [opening the oyster - succeeded]

[Rule "A first turn sequence rule" applies.]
[Rule "every turn stage rule" applies.]
[Rule "A last turn sequence rule" applies.]
[Rule "notify score changes rule" applies.]
[Your score has just gone up by two points.]

>eat oyster
[Rule "declare everything initially unmentioned rule" applies.]
[eating the oyster]
[Rule "announce items from multiple object lists rule" applies.]
[Rule "set pronouns from items from multiple object lists rule" applies.]
[Rule "before stage rule" applies.]
[Rule "instead stage rule" applies.]
[Rule "investigate player's awareness before action rule" applies.]
[Rule "player aware of his own actions rule" applies.]
[Rule "check stage rule" applies.]
[Rule "check before eating rule" applies.]
[Rule "can't eat unless edible rule" applies.]
[Rule "can't eat clothing without removing it first rule" applies.]
[Rule "can't eat other people's food rule" applies.]
[Rule "can't eat portable food without carrying it rule" applies.]
[Rule "carry out stage rule" applies.]
[Rule "eat oyster rule" applies.]
You slurp down the contents of the oyster, and toss the shell away.

[Rule "standard eating rule" applies.]
[Rule "after stage rule" applies.]
[Rule "investigate player's awareness after action rule" applies.]
[Rule "report stage rule" applies.]
[Rule "standard report eating rule" applies.]
You eat the oyster. Not bad.
[Rule "last specific action-processing rule" applies.]
[eating the oyster - succeeded]

[Rule "A first turn sequence rule" applies.]
[Rule "every turn stage rule" applies.]
[Rule "A last turn sequence rule" applies.]
[Rule "notify score changes rule" applies.]

* * *

The Beach
An Interactive Fiction
Release 1 / Serial number 210310 / Inform 7 build 6M62 (I6/v6.34 lib 6/12N) SD

Beach
You're on a muddy beach at low tide. There are probably oysters under the mud.

You can see several oysters and a funny tool here.

>take oysters
You dig in the mud and come up with an oyster.

>i
You are carrying nothing.

* * *

>i
You are carrying nothing.

* * *

>take oysters
You dig in the mud and come up with an oyster.

>x oystere
You can't see any such thing.

>x tool
The tool has a rubber handle and a wide, flat, rounded blade.

Aha! It's an oyster knife.

>get knife
You can't see any such thing.

>i
You are carrying:
  an oyster (closed)

>get oyster knife
Taken.

>i
You are carrying:
  an oyster knife
  an oyster (closed)

* * *

The Beach
An Interactive Fiction
Release 1 / Serial number 210310 / Inform 7 build 6M62 (I6/v6.34 lib 6/12N) SD

Beach
You're on a muddy beach at low tide. There are probably oysters under the mud.

You can see several oysters and a funny tool here.

>test me
(Testing.)

>[1] take tool
Taken.

>[2] take oyster
You dig in the mud and come up with an oyster.

[Your score has just gone up by one point.]

>[3] x tool
The tool has a rubber handle and a wide, flat, rounded blade.

Aha! It's an oyster knife.

>[4] open oyster

You work the blade of the oyster knife carefully into the corner of the oyster and twist until it pops open.

>[5] eat oyster
You slurp down the contents of the oyster, and toss the shell away.

[Your score has just gone up by one point.]

>[6] take oyster
You dig in the mud and come up with an oyster.

Taken.

>[7] open oyster

You work the blade of the oyster knife carefully into the corner of the oyster and twist until it pops open.

>[8] eat oyster
You slurp down the contents of the oyster, and toss the shell away.

You eat the oyster. Not bad.

>[9] take oyster
You dig in the mud and come up with an oyster.

Taken.

>[10] open oyster

You work the blade of the oyster knife carefully into the corner of the oyster and twist until it pops open.

The oyster shell is full of mud! You toss it away in disgust. 

It's probably worth another try.

>[11] take oyster
You dig in the mud and come up with an oyster.

Taken.

>[12] open oyster

You work the blade of the oyster knife carefully into the corner of the oyster and twist until it pops open.

I'm rich!

To your surprise, there is a pearl glistening on top of the oyster meat. You carefully pick it out. 
[Your score has just gone up by two points.]

>get oyster
You already have that.

>eat me
You're plainly inedible.

>eat meat
You can't see any such thing.

>open oyster
It's closed tightly. You need to find something you can use to to open it.

>eat meat
You can't see any such thing.

>get tool
Taken.

>x tool
It has a rubber handle and a wide, flat, rounded blade.

Aha! It's an oyster knife.

>restart
Are you sure you want to restart?

>y
Oysters
An Interactive Fiction
Release 1 / Serial number 210304 / Inform 7 build 6M62 (I6/v6.34 lib 6/12N) SD

Beach
You're on a muddy beach at low tide. There are probably oysters under the mud.

You can see several oysters and a funny tool here.

>get tool
Taken.

>x tool
It has a rubber handle and a wide, flat, rounded blade.

>get oyster
You dig in the mud and come up with an oyster.

>open oyster
You work the blade carefully into the corner of the oyster and twist until it pops open.

>x tool
It has a rubber handle and a wide, flat, rounded blade.

Aha! It's an oyster knife.

>open oyster with knife
You can't see any such thing.

* * *

>open oyster
You work the knife blade carefully into the corner of the oyster and twist until it pops open.

>eat oyster
You slurp down the oyster, and toss the shell away.

>get oyster
You dig up an oyster from the mud.

>open oyster
You work the knife blade carefully into the corner of the oyster and twist until it pops open.
The oyster is full of mud! You toss it away in disgust.

>i
You are carrying:
  a knife

>get oyster
You dig up an oyster from the mud.

* * *

>open oyster
You work the knife blade carefully into the corner of the oyster and twist until it pops open.
The oyster is full of mud! You toss it away in disgust.

>get oyster
You dig up an oyster from the mud.

>open oyster
You work the knife blade carefully into the corner of the oyster and twist until it pops open.

* * *

>get oyster
You already have that.

>x oyster
It's a rough, oblong, oyster shell, with a couple of barnacles attached and some specks of mud.

>open oyster
You work the knife blade carefully into the corner of the oyster and twist until it pops open.

>x oyster
It's a rough, oblong, oyster shell, with a couple of barnacles attached and some specks of mud.

In the oyster are some meat.

>eat oyster
You slurp down the contents of the oyster, and toss the shell away.

>i
You are carrying:
  a knife

>get oyster
You dig in the mud and come up with an oyster.

>eat oyster
You need to open the oyster first.

>open oyster
You work the knife blade carefully into the corner of the oyster and twist until it pops open.
To your surprise, there is a pearl glistening on top of the oyster body. You carefully pick it out.

>eat oyster
You slurp down the contents of the oyster, and toss the shell away.

>get oyster; open oyster
You can't see any such thing.

>get oyster / open oyster
I only understood you as far as wanting to get several oysters.

>get oyster / open oyster
I only understood you as far as wanting to get several oysters.

>eat oyster
You're not holding an oyster.

>get oyster
You dig in the mud and come up with an oyster.

>open oyster
You work the knife blade carefully into the corner of the oyster and twist until it pops open.

* * *

>get oyster
You already have that.

>open oyster
It's already open!

>x
What do you want to examine?

>i
You are carrying:
  an oyster (open)
    some meat
  a pearl
  a knife

>eat meat
You slurp down the contents of the oyster, and toss the shell away.

>i
You are carrying:
  a pearl
  a knife

>eat oyster
You're not holding an oyster.

* * *

>i
You are carrying:
  a pearl
  an oyster (open)
    meat
  an oyster knife

>eat oyster
You slurp down the contents of the oyster, and toss the shell away.

* * *

>i
You are carrying:
  a funny tool

>look
Beach
You're on a muddy beach at low tide. There are probably oysters under the mud.

You can see several oysters here.

* * *

>look
Beach
You're on a muddy beach at low tide. There are probably oysters under the mud.

You can see several oysters here.

>i
You are carrying:
  a funny tool

* * *

>take oyster
You already have one!

>i
You are carrying:
  a pearl
  an oyster (open)
    meat
  an oyster knife

* * *

>eat oyster
You slurp down the contents of the oyster, and toss the shell away.

>take oyster
You dig in the mud and come up with an oyster.

>drop oyster
Dropped.

>i
You are carrying:
  a pearl
  an oyster knife

>l
Beach
You're on a muddy beach at low tide. There are probably oysters under the mud.

You can see an oyster (closed) and several oysters here.

>get oyster
[Your score has just gone up by one point.]

* * *

>take oyster
You already have one!

>open oyster
You work the blade of the oyster knife carefully into the corner of the oyster and twist until it pops open.

* * *

>x knife
It's an oyster knife.