MomInPerson
An Interactive Fiction by Kent Quirk
Release 1 / Serial number 210311 / Inform 7 build 6M62 (I6/v6.34 lib 6/12N) SD

Funeral Home Lobby
You're in the lobby of a funeral home, full of uncomfortable furniture, tissues, and small bottles of water. The exit is north. It's just after Uncle Rob's wake. The last few mourners are waiting in a receiving line to pay their respects to your mother, his closest relative. You've managed to escape from your duties in the line, claiming your feet hurt. You avoid eye contact with the mourners, sipping obsessively from a tiny bottle of water, trying to avoid looking like someone people should talk to.

Mom is, as usual, holding it together even after a couple of hours. She looks around for you and gestures for you to join her. You take a deep breath and walk over.

"I need you to go to Rob's house."

She's looking appropriately severe at the head of the receiving line, all in black, giving each mourner in turn her full attention.

You should ask mom about the house.

>actions
Actions listing on.

>ask mom about van
[asking Mom about "van"]
She digs in her purse. "The van is in the parking lot. Here's the key."

[asking Mom about "van" - failed]

>showme mom
Mom - person
    van key
location: in the lobby
singular-named, proper-named; unlit, inedible, portable; male
list grouping key: none
printed name: "Mom"
printed plural name: "people"
indefinite article: none
description: "She's your mom."
initial appearance: "Mom is, as usual, holding it together even after a couple of hours. She's looking appropriately severe at the head of the receiving line, all in black, giving each mourner in turn her full attention."
carrying capacity: 100

>mom, give key to me
[asking Mom to try giving the van key to yourself]
Mom has better things to do.
[asking Mom to try giving the van key to yourself - failed]

>give key to me
[giving the van key to yourself]
(first taking the van key)
[(1) taking the van key - silently]
That seems to belong to Mom.
[(1) taking the van key - silently - failed the can't take people's possessions rule]

[giving the van key to yourself - failed the carrying requirements rule]

* * *

>actions
Actions listing on.

>rules
Rules tracing now switched on. Type "rules off" to switch it off again, or "rules all" to include even rules which do not apply.

>ask about house
[Rule "declare everything initially unmentioned rule" applies.]
[asking-anyone "house"]
[Rule "announce items from multiple object lists rule" applies.]
[Rule "set pronouns from items from multiple object lists rule" applies.]
[Rule "before stage rule" applies.]
[Rule "instead stage rule" applies.]
[Rule "investigate player's awareness before action rule" applies.]
[Rule "player aware of his own actions rule" applies.]
[Rule "check stage rule" applies.]
[Rule "carry out stage rule" applies.]
[Rule "Carry out asking-anyone" applies.]
[(1) asking Mom about "house"]
[Rule "announce items from multiple object lists rule" applies.]
[Rule "set pronouns from items from multiple object lists rule" applies.]
[Rule "before stage rule" applies.]
[Rule "instead stage rule" applies.]
[Rule "Instead of asking Mom about" applies.]
0house - 0
*** Run-time problem P22: Attempt to look up a non-existent row in the table 'Table of Mom Conversation'.

Mom shrugs vaguely.

Glulxe fatal error: Memory access out of range (7BA0004)

* * *

>ask about house
"You'll need keys. Here. Just put stuff in the van."

She hands you a keychain.

[Your score has just gone up by one point.]

>ask mom about house
"You'll need keys. Here."

She hands you a keychain.

>i
You are carrying:
  a keychain

>ask mom about van
"Oh, right." She digs in her purse. "It's the white van in the parking lot. Here's the key."

She hands you a van key.

>ask mom about rob
"Listen," she hisses. "Your brother has already left with his kids and you're not flying back until tomorrow. Just go to the house and clean out his stuff."

>ask mom about stuff
"What kind of ... 'stuff' ... do you mean?", you ask.

She shoots you a whithering look. "Don't be obtuse. The kinds of things we don't want showing up in an estate sale. I'm sure you'll figure it out. You can call me if you have questions. You can put things in there or the van. Now get out of here! I'll deal with the funeral home."

She hands you a totebag.

* * *

>ask about house
"You'll need keys. Here. Just put stuff in the van."

She hands you a keychain.

[Your score has just gone up by one point.]

>ask mom about the house
Mom shrugs vaguely.

>ask mom what stuff
"What kind of ... 'stuff' ... do you mean?", you ask.

She shoots you a whithering look. "Don't be obtuse. The kinds of things we don't want showing up in an estate sale, of course. I'm sure you'll figure it out. You can call me if you have questions. Now get out of here! I'll deal with the funeral home."

She gives you a totebag.

[Your score has just gone up by one point.]

>ask mom about stuff
Mom raises one eyebrow.

>x keychain
You see nothing special about the keychain.

>look
Funeral Home Lobby
You're in the lobby of a funeral home, full of uncomfortable furniture, tissues, and small bottles of water. The exit is north. 

She's looking appropriately severe at the head of the receiving line, all in black, giving each mourner in turn her full attention.

You should ask mom about the house.

>north
You should check to see if the van key is on that keychain.

>ask mom for van key
"Oh, right. Just put things in the van. It's the white van out in the parking lot." She digs in her purse. "Here's the key."

She hands you a van key.

[Your score has just gone up by one point.]

>ask mom about van key
Mom turns back to the receiving line and greets whoever is next.

>n
parking lot

>actions
Actions listing on.

>ask about house
[asking-anyone "house"]
[asking-anyone "house" - succeeded]

>s
[going south]

Funeral Home Lobby
You're in the lobby of a funeral home, full of uncomfortable furniture, tissues, and small bottles of water. The exit is north. 

She's looking appropriately severe at the head of the receiving line, all in black, giving each mourner in turn her full attention.

You should ask mom about the house.

[going south - succeeded]

>ask about house
[asking-anyone "house"]
[(1) asking Mom about "house"]
Mom looks around impatiently.

[(1) asking Mom about "house" - failed]

[asking-anyone "house" - succeeded]

>ask mom about house
[asking Mom about "house"]
Mom points north at the exit.

[asking Mom about "house" - failed]

>ask about water
[asking-anyone "water"]
[(1) asking Mom about "water"]
Mom points north at the exit.

[(1) asking Mom about "water" - failed]

[asking-anyone "water" - succeeded]

* * *

>ask mom about funeral
"It will be over soon. But you can go to Rob's house right now".

>ask mom about scissors
There is no reply.

>say hi mom
(to Mom)
There is no reply.

>ask mom about house
"You'll need keys. Here."

>take keys from mom
You can't see any such thing.

>look at mom
She's your mom.

* * *

>ask mom about house
Row 1 default default 0 
Row 1 default default 0 
1house - 1Mom shrugs vaguely.

* * *

>ask mom about the house
the house - 3
"You'll need keys. Here. Just put stuff in the van."

She hands you a keychain.

[Your score has just gone up by one point.]

>ask mom about the house
defaultme
defaultfuneral|burial|service|wake
defaultRob|brother|uncle
defaultstuff|things
defaultclean
defaultvan|key|keys|car|travel
defaultmourners
defaultdefault
the house - 10
Mom shrugs vaguely.

* * *

>ask mom about the house
the house - 3
"You'll need keys. Here. Just put stuff in the van."

She hands you a keychain.

[Your score has just gone up by one point.]

>kiss mom
You kiss Mom chastely on the cheek. She smiles a bit and says "Thank you. I raised you well."

* * *

>ask mom about the house
the house - 3
"You'll need keys. Here. Just put stuff in the van."

She hands you a keychain.

[Your score has just gone up by one point.]

>x keychain
You see nothing special about the keychain.

>ask mom about the van
"Oh, right." She digs in her purse. "It's the white van in the parking lot. Here's the key."

She hands you a van key.

>ask mom
What do you want to ask Mom for?

>stuff
You can't see any such thing.

>ask mom about stuff
"What kind of ... 'stuff' ... do you mean?", you ask.

She shoots you a whithering look. "Don't be obtuse. The kinds of things we don't want showing up in an estate sale. I'm sure you'll figure it out. You can call me if you have questions. You can put things in the van. Now get out of here! I'll deal with the funeral home."

She gives you a totebag.

* * *

>hit mom
Violence isn't the answer to this one.

>eat mom
She's plainly inedible.

* * *

>look
lobby
Mom is, as usual, holding it together even after a couple of hours. She's looking appropriately severe at the head of the receiving line, all in black, giving each mourner in turn her full attention.

>ask mom about rob
She sighs audibly. "I don't have all day, so can you be more specific?"

>ask mom about funeral
"Oh, it was just lovely to see all of those people ... who have ignored Rob for years." Sometimes Mom can be pretty sarcastic.

* * *

>north
You wonder how you are going to get in. Maybe you should ask mom about the house.

>ask mom  about the house.
Mom shrugs vaguely.

>ask mom  about the house
"You'll need keys. Here. Just put stuff in the van."

She hands you a keychain.

[Your score has just gone up by one point.]

>x keychain
You see nothing special about the keychain.

>actions
Actions listing on.

>ask mom about blah
[asking Mom about "blah"]
Mom looks around impatiently.
[asking Mom about "blah" - failed]

>n
[going north]
You should check to see if the van key is on that keychain.
[going north - failed the Check going north when the player is in the lobby]

>x keychain
[examining the keychain]
You see nothing special about the keychain.

[examining the keychain - succeeded]

>ask mom about van key
[asking Mom about "van key"]
"Oh, right. Just put things in the van. It's the white van out in the parking lot." She digs in her purse. "Here's the key."

She gives you a van key.
[asking Mom about "van key" - failed]

[Your score has just gone up by one point.]

>n
[going north]
You feel like you should ask mom about that stuff.
[going north - failed the Check going north when the player is in the lobby]

>ask mom about that stuff
[asking Mom about "that stuff"]
"What kind of ... 'stuff' ... do you mean?", you ask.

She shoots you a whithering look. "Don't be obtuse. The kinds of things we don't want showing up in an estate sale, of course. I'm sure you'll figure it out. You can call me if you have questions. Now get out of here! I'll deal with the funeral home."

She hands you a totebag.
[asking Mom about "that stuff" - failed]

[Your score has just gone up by one point.]

>restart
[restarting the game]
Are you sure you want to restart?

>yes
MomInPerson
An Interactive Fiction by Kent Quirk
Release 1 / Serial number 210310 / Inform 7 build 6M62 (I6/v6.34 lib 6/12N) SD

lobby
It's a funeral home lobby, full of uncomfortable furniture, tissues, and small bottles of water.

She's looking appropriately severe at the head of the receiving line, all in black, giving each mourner in turn her full attention.

You should ask mom about the house.

>ask mom about the house
"You'll need keys. Here. Just put stuff in the van."

She hands you a keychain.

[Your score has just gone up by one point.]

>i
You are carrying:
  a keychain

>n
You should check to see if the van key is on that keychain.

>ask mom about the house
Mom turns back to the receiving line and greets whoever is next.

>ask mom about the van
"Oh, right. Just put things in the van. It's the white van out in the parking lot." She digs in her purse. "Here's the key."

She gives you a van key.

[Your score has just gone up by one point.]

>n
You feel like you should ask mom about that stuff.

>ask mom about the stuff
"What kind of ... 'stuff' ... do you mean?", you ask.

She shoots you a whithering look. "Don't be obtuse. The kinds of things we don't want showing up in an estate sale, of course. I'm sure you'll figure it out. You can call me if you have questions. Now get out of here! I'll deal with the funeral home."

She hands you a totebag.

[Your score has just gone up by one point.]

>n
parking lot

>x mourners
You can't see any such thing.

>talk to mourners
That's not a verb I recognise.

>look
parking lot

* * *

>showme Table of Mom Conversation
There seems to be no such object anywhere in the model world.

* * *

>showme lobby
lobby - room
    yourself - person
    Furniture
    Tissues
    Small bottles of water
    mourners
    Mom - person
singular-named, improper-named; lighted, visited
list grouping key: none
printed name: "lobby"
printed plural name: none
indefinite article: none
description: "It's the lobby of a funeral home, full of uncomfortable furniture, tissues, and small bottles of water. "

>look
lobby
It's the lobby of a funeral home, full of uncomfortable furniture, tissues, and small bottles of water. 

She's looking appropriately severe at the head of the receiving line, all in black, giving each mourner in turn her full attention.

You should ask mom about the house.

>take tissue
You take one, blow your nose, and surreptitiously stuff the tissue into the cracks of a nearby couch.

>take tissues
You take one, blow your nose, and surreptitiously stuff the tissue into the cracks of a nearby couch.

>take water
You're really not thirsty right now.

>drink water
You don't know where it came from.

>sit on furniture
It looks way too uncomfortable.

>actions
Actions listing on.

>sit on furniture
[entering Furniture]
It looks way too uncomfortable.
[entering Furniture - failed]

>actions off
Actions listing off.

>take furniture
That's hardly portable.

>x furniture
It's overstuffed and undercomfortable.

>x water
Bulk-purchased at the local big box store.

>x tissues
Guaranteed to dry your tears and scratch your skin.

>n
You wonder how you are going to get in. Maybe you should ask mom about the house.

>ask mom about the funeral
Mom turns back to the receiving line and greets whoever is next.

>ask mom about the burial
Mom looks around impatiently.

>ask mom about her brother
"Listen," she hisses. "Your brother has already left with his kids and you're not flying back until tomorrow. Just go to the house and clean out his stuff."

>ask mom bout me
I didn't understand that sentence.

>ask mom about me
"Stop complaining. Your brother is so busy and you've certainly got nothing better to do, as far as I can tell."