Telephone
An Interactive Fiction
Release 1 / Serial number 210306 / Inform 7 build 6M62 (I6/v6.34 lib 6/12N) SD

Guard House
Here you spend all your nights. Bullet-proof windows offer a panoramic view of serene cliffs, palm trees, and a moonlit ocean. Occasionally someone is foolish enough to try a cliff ascent or even an attack by helicopter, but lately things have been pretty quiet.

The mansion is up the hill behind you, security lights ablaze.

Before you is a grey telephone. In black marker someone has written on it: MAIN OFFICE 2802.

>call mom
(on the grey telephone)

"You can't be done yet," your mother answers with annoyance. You'd think she'd be a little less businesslike, given that her brother just died.

>ask mom about me
"Stop complaining. Your brother is so busy and you've certainly got nothing better to do, as far as I can tell."
(Hah. He's probably drinking and watching the game.)

>ask mom about bike
"He had a nice bike, but I haven't seen him ride it lately."

[Your score has just gone up by one point.]

>ask mom about bike
"He had a nice bike, but I haven't seen him ride it lately."

* * *

>ask mom about me
"Stop complaining. Your brother is so busy and you've certainly got nothing better to do, as far as I can tell."
(Hah. He's probably drinking and watching the game.)

>ask mom about me
"Stop complaining. Your brother is so busy and you've certainly got nothing better to do, as far as I can tell."

>ask mom about rob
"Well, what do you want to know about him?"
()

* * *

>ask mom about me
"Stop complaining. Your brother is so busy and you've certainly got nothing better to do, as far as I can tell."
(Hah. He's probably drinking and watching the game.)

>ask mom about rob
"Well, what do you want to know about him?"

>ask mom about hat
"His HAT? Why?!?...nevermind. Yeah, he always wore a stupid baseball hat. He thought it was hilarious. If you find it, burn it."

Please don't do that yet.

* * *

>ask mom about rob
"Well, what do you want to know about him?"

>call pizza
(on the grey telephone)

(first ending your conversation with Mom)
"Hello?" says the pizza delivery boy.

>ask about pizza
You can't see any such thing.

>ask about delivery
You can't see any such thing.

>ask boy about delivery
"Well, I don't know," says the boy in a worried voice. "Last time I came there were attack dogs. And ninjas."

>ask boy about pizza
"Pepperoni special tonight!" he says proudly.

>ask boy about pepperoni
"Pepperoni is included free on ALL our pizzas," he says proudly.

>hang up
(the grey telephone)
You put down the grey telephone, cutting the connection.

>say hellp
(to yourself)
Best to confine your conversation to questions and answers.

>actionos
That's not a verb I recognise.

>actions
Actions listing on.

>say hello
(to yourself)
[answering yourself that "hello"]
Best to confine your conversation to questions and answers.
[answering yourself that "hello" - ended without result]

>actions
Actions listing on.

>actions off
Actions listing off.

* * *

>call mom
(on the grey telephone)

"You can't be done yet," your mother answers with annoyance. You'd think she'd be a little less businesslike, given that her brother just died.

>hang up
(the grey telephone)
You put down the grey telephone, cutting the connection.

>call mom
(on the grey telephone)

"Hello?" says Mom.

>goodbye
(the grey telephone)
You put down the grey telephone, cutting the connection.

>call the family phone
(on the grey telephone)

"Hello?" says Mom.

>call the station phone
(on the grey telephone)

(first ending your conversation with Mom)
"Hello?" says the Police Officer.

* * *

Telephone
An Interactive Fiction
Release 1 / Serial number 210306 / Inform 7 build 6M62 (I6/v6.34 lib 6/12N) SD

Guard House
Here you spend all your nights. Bullet-proof windows offer a panoramic view of serene cliffs, palm trees, and a moonlit ocean. Occasionally someone is foolish enough to try a cliff ascent or even an attack by helicopter, but lately things have been pretty quiet.

The mansion is up the hill behind you, security lights ablaze.

Before you is a grey telephone. In black marker someone has written on it: MAIN OFFICE 2802.

>dial 2802
(on the grey telephone)

"You can't be done yet," your mother answers with annoyance. You'd think she'd be a little less businesslike, given that her brother just died.

>say pizza
(to Mom)
Best to confine your conversation to questions and answers.

>say pizza?
(to Mom)
Best to confine your conversation to questions and answers.

>how about a night of passion?
That's not a verb I recognise.

>ask boss about a night of passion
You can't see any such thing.

>ask boss about love
You can't see any such thing.

>ask boss about pizza
You can't see any such thing.

>hang up
(the grey telephone)
You put down the grey telephone, cutting the connection.

>look
Guard House
Here you spend all your nights. Bullet-proof windows offer a panoramic view of serene cliffs, palm trees, and a moonlit ocean. Occasionally someone is foolish enough to try a cliff ascent or even an attack by helicopter, but lately things have been pretty quiet.

The mansion is up the hill behind you, security lights ablaze.

Before you is a grey telephone. In black marker someone has written on it: MAIN OFFICE 2802.

>out
But you aren't in anything at the moment.

>i
You are carrying nothing.

>l
Guard House
Here you spend all your nights. Bullet-proof windows offer a panoramic view of serene cliffs, palm trees, and a moonlit ocean. Occasionally someone is foolish enough to try a cliff ascent or even an attack by helicopter, but lately things have been pretty quiet.

The mansion is up the hill behind you, security lights ablaze.

Before you is a grey telephone. In black marker someone has written on it: MAIN OFFICE 2802.

>up
And leave your post? The boss would have you flayed. No kidding.

>down
And leave your post? The boss would have you flayed. No kidding.

>w
And leave your post? The boss would have you flayed. No kidding.

>call delivery boy
(on the grey telephone)

"Hello?" says the pizza delivery boy.

>ask boy about cheese
"We use four kinds," says the boy, then lowers his voice confidentially. "Actually, two of them are the same. Nobody ever counts. The stringy one, the one that comes in dollops and the orangey one. You know."

>ask boy about pepperoni
"Pepperoni is included free on ALL our pizzas," he says proudly.

>ask boy about no pepperoni
"Well, I don't see why you'd want that," replies the boy sniffily. "It's free!"

>ask boy about delivery
"Well, I don't know," says the boy in a worried voice. "Last time I came there were attack dogs. And ninjas."

>tell boy about massive gratuity
"There's no use in a big tip you don't live to spend," says the delivery boy quite firmly.

>ask boy about bacon
The pizza delivery boy does not reply.

>ask boy about ninja
The pizza delivery boy does not reply.

>attack boy
Though you're on the line with the pizza delivery boy, you can't physically reach to Potter's Pizza.

>call ninja
(first ending your conversation with the pizza delivery boy)
The phone rings and rings but no one answers.

>call ninjas
The phone rings and rings but no one answers.

>call 4431
The phone rings and rings but no one answers.

>ask ninja about attack
You can't see any such thing.

>ask ninja about imminentattack
You can't see any such thing.

>ask ninja about imminent attack
You can't see any such thing.

>ask ninja about pizza delivery boy
You can't see any such thing.

>look at ninja
You can't see any such thing.

>hang up
(the grey telephone)
You're not on the line with anyone.

>x phone
You see nothing special about the grey telephone.

* * *

Telephone
An Interactive Fiction
Release 1 / Serial number 210306 / Inform 7 build 6M62 (I6/v6.34 lib 6/12N) SD

Guard House
Here you spend all your nights. Bullet-proof windows offer a panoramic view of serene cliffs, palm trees, and a moonlit ocean. Occasionally someone is foolish enough to try a cliff ascent or even an attack by helicopter, but lately things have been pretty quiet.

The mansion is up the hill behind you, security lights ablaze.

Before you is a grey telephone. In black marker someone has written on it: MAIN OFFICE 2802.

>dial mom
(on the grey telephone)

"You can't be done yet," your mother answers with annoyance. You'd think she'd be a little less businesslike, given that her brother just died.

>ask mom about Rob
"Well, what do you want to know about him?"

>ask mom about hat
"His HAT? Why?!?...nevermind. Yeah, he always wore a stupid baseball hat. He thought it was hilarious. If you find it, burn it."

>ask mom about her brother
"Well, what do you want to know about him?"

>ask mom about bike
"He had a nice bike, but I haven't seen him ride it lately."

>ask mom about alarm
"Oh, I forgot to mention, the alarm code is the house number."

>ask mom about cop
"Oh COME ON! You've been there for like 5 minutes and the police have already arrived?"

>ask mom about military
She is quiet for a moment. "I think he was proud of his service in Afghanistan, but he never ever wanted to talk about it with me. I think you'd have to find someone he knew with a military background."

>listen to mom
Though you're on the line with Mom, you can't physically reach to the Family Home.
Mom is waiting for you to carry on the conversation.

>listen to phone
You can hear Mom breathing.

>goodbye
You must supply a noun.