Garden
An Interactive Fiction
Release 1 / Serial number 210310 / Inform 7 build 6M62 (I6/v6.34 lib 6/12N) SD

Garden
There is an alarmingly blue flagpole here.

You can also see a pride flag here.

>actions
Actions listing on.

>rules
Rules tracing now switched on. Type "rules off" to switch it off again, or "rules all" to include even rules which do not apply.

>hang flag on pole
[Rule "declare everything initially unmentioned rule" applies.]
[flag-hanging the pride flag]
[Rule "announce items from multiple object lists rule" applies.]
[Rule "set pronouns from items from multiple object lists rule" applies.]
[Rule "before stage rule" applies.]
[Rule "instead stage rule" applies.]
[Rule "investigate player's awareness before action rule" applies.]
[Rule "player aware of his own actions rule" applies.]
[Rule "check stage rule" applies.]
[Rule "Check flag-hanging" applies.]
You aren't holding a flag!
[flag-hanging the pride flag - failed the Check flag-hanging]

[Rule "A first turn sequence rule" applies.]
[Rule "every turn stage rule" applies.]
[Rule "A last turn sequence rule" applies.]
[Rule "notify score changes rule" applies.]

>rules off
[Rule "declare everything initially unmentioned rule" applies.]
Rules tracing now switched off. Type "rules" to switch it on again.

>actions off
Actions listing off.

>hang flag on pole
You aren't holding a flag!

>get flag
Taken.

>hang flag on pole
The pride flag is hanging at the bottom of the blue pole.

* * *

Garden
An Interactive Fiction
Release 1 / Serial number 210310 / Inform 7 build 6M62 (I6/v6.34 lib 6/12N) SD

Garden
There is an alarmingly blue flagpole here.

You can also see a pride flag here.

>get flag
Taken.

>put flag
(on the blue pole)
The pride flag is hanging at the bottom of the blue pole.

[Your score has just gone up by one point.]

>raise flag
notice: A pride flag is waving in the breeze at the top of the blue pole.
You raise the flag to the top of the pole. A pride flag is waving in the breeze at the top of the blue pole.
.

>lower flag
notice: A pride flag is fluttering proudly at half-mast on the blue pole.
half mast!
You lower the flag a bit. A pride flag is fluttering proudly at half-mast on the blue pole.
.

[Your score has just gone up by one point.]

>lower flag
notice: A pride flag is hanging limply near the bottom of the blue pole.
You lower the flag a bit. A pride flag is hanging limply near the bottom of the blue pole.
.

>rules
Rules tracing now switched on. Type "rules off" to switch it off again, or "rules all" to include even rules which do not apply.

>raise flag
[Rule "declare everything initially unmentioned rule" applies.]
[Rule "announce items from multiple object lists rule" applies.]
[Rule "set pronouns from items from multiple object lists rule" applies.]
[Rule "before stage rule" applies.]
[Rule "instead stage rule" applies.]
[Rule "investigate player's awareness before action rule" applies.]
[Rule "player aware of his own actions rule" applies.]
[Rule "check stage rule" applies.]
[Rule "Check flag-raising" applies.]
[Rule "carry out stage rule" applies.]
[Rule "Carry out flag-raising" applies.]
notice: A pride flag is waving in the breeze at the top of the blue pole.
You raise the flag to the top of the pole. A pride flag is waving in the breeze at the top of the blue pole.
.
[Rule "after stage rule" applies.]

[Rule "investigate player's awareness after action rule" applies.]
[Rule "report stage rule" applies.]
[Rule "last specific action-processing rule" applies.]
[Rule "A first turn sequence rule" applies.]
[Rule "every turn stage rule" applies.]
[Rule "A last turn sequence rule" applies.]
[Rule "notify score changes rule" applies.]

>lower flag
[Rule "declare everything initially unmentioned rule" applies.]
[Rule "announce items from multiple object lists rule" applies.]
[Rule "set pronouns from items from multiple object lists rule" applies.]
[Rule "before stage rule" applies.]
[Rule "instead stage rule" applies.]
[Rule "investigate player's awareness before action rule" applies.]
[Rule "player aware of his own actions rule" applies.]
[Rule "check stage rule" applies.]
[Rule "Check flag-lowering" applies.]
[Rule "carry out stage rule" applies.]
[Rule "Carry out flag-lowering" applies.]
notice: A pride flag is fluttering proudly at half-mast on the blue pole.
half mast!
You lower the flag a bit. A pride flag is fluttering proudly at half-mast on the blue pole.
.
[Rule "after stage rule" applies.]

[Rule "investigate player's awareness after action rule" applies.]
[Rule "report stage rule" applies.]
[Rule "last specific action-processing rule" applies.]
[Rule "A first turn sequence rule" applies.]
[Rule "every turn stage rule" applies.]
[Rule "A last turn sequence rule" applies.]
[Rule "notify score changes rule" applies.]
[Your score has just gone up by one point.]

>lower flag
[Rule "declare everything initially unmentioned rule" applies.]
[Rule "announce items from multiple object lists rule" applies.]
[Rule "set pronouns from items from multiple object lists rule" applies.]
[Rule "before stage rule" applies.]
[Rule "instead stage rule" applies.]
[Rule "investigate player's awareness before action rule" applies.]
[Rule "player aware of his own actions rule" applies.]
[Rule "check stage rule" applies.]
[Rule "Check flag-lowering" applies.]
[Rule "carry out stage rule" applies.]
[Rule "Carry out flag-lowering" applies.]
notice: A pride flag is hanging limply near the bottom of the blue pole.
You lower the flag a bit. A pride flag is hanging limply near the bottom of the blue pole.
.
[Rule "after stage rule" applies.]

[Rule "investigate player's awareness after action rule" applies.]
[Rule "report stage rule" applies.]
[Rule "last specific action-processing rule" applies.]
[Rule "A first turn sequence rule" applies.]
[Rule "every turn stage rule" applies.]
[Rule "A last turn sequence rule" applies.]
[Rule "notify score changes rule" applies.]

* * *

>get flag
Taken.

>put flag on pole
The pride flag is hanging at the bottom of the blue pole.

[Your score has just gone up by one point.]

>get flag
Taken.

* * *

>hang flag on pole
The pride flag is hanging at the bottom of the blue pole.

>lower flag
The flag is as low as it can go.

>raise flag
You raise the flag to the top of the pole. A pride flag is waving in the breeze at the top of the blue pole.
.

>lower flag
You lower the flag a bit. A pride flag is fluttering proudly at half-mast on the blue pole.
.

>lower flag
You lower the flag a bit. A pride flag is hanging limply near the bottom of the blue pole.
.

* * *

>put flag on pole
The pride flag is hanging at the bottom of the blue pole.

[Your score has just gone up by one point.]

>raise flag
You raise the flag to the top of the pole. A pride flag is waving in the breeze at the top of the blue pole.
.

* * *

>lower flag
You lower the flag a bit. A pride flag is fluttering proudly at half-mast on the blue pole.
.

>lower flag
blue poleYou lower the flag a bit. A pride flag is hanging limply near the bottom of the blue pole.
.

* * *

>get flag
Taken.

>raise flag
There is no flag on the blue pole to raise!

>put flag on pole
The pride flag is hanging at the bottom of the blue pole.

[Your score has just gone up by one point.]

>raise flag
notice: A pride flag is waving in the breeze at the top of the blue pole.
You raise the flag to the top of the pole. A pride flag is waving in the breeze at the top of the blue pole.
.

* * *

Garden
An Interactive Fiction
Release 1 / Serial number 210310 / Inform 7 build 6M62 (I6/v6.34 lib 6/12N) SD

Garden
There is an alarmingly blue flagpole here.

You can also see a pride flag here.

>look
Garden
There is an alarmingly blue flagpole here.

You can also see a pride flag here.

>get flag
Taken.

>put flag on pole
You put the pride flag on the blue pole.

>raise flag
You raise the flag to the top of the pole.

>i
You are carrying nothing.

>look
Garden
It's a shockingly blue flagpole.

On the blue pole is a pride flag.

>actions
Actions listing on.

* * *

>rules
Rules tracing now switched on. Type "rules off" to switch it off again, or "rules all" to include even rules which do not apply.

>look
[Rule "declare everything initially unmentioned rule" applies.]
[Rule "determine visibility ceiling rule" applies.]
[looking]
[Rule "announce items from multiple object lists rule" applies.]
[Rule "set pronouns from items from multiple object lists rule" applies.]
[Rule "before stage rule" applies.]
[Rule "instead stage rule" applies.]
[Rule "investigate player's awareness before action rule" applies.]
[Rule "player aware of his own actions rule" applies.]
[Rule "check stage rule" applies.]
[Rule "carry out stage rule" applies.]
[Rule "declare everything unmentioned rule" applies.]
[Rule "room description heading rule" applies.]
Garden
[Rule "room description body text rule" applies.]
[Rule "room description paragraphs about objects rule" applies.]
[Rule "initialise locale description rule" applies.]
[Rule "find notable locale objects rule" applies.]
[Rule "standard notable locale objects rule" applies.]
[Rule "interesting locale paragraphs rule" applies.]
[Rule "don't mention player's supporter in room descriptions rule" applies.]
[Rule "don't mention scenery in room descriptions rule" applies.]
[Rule "don't mention undescribed items in room descriptions rule" applies.]
[Rule "set pronouns from items in room descriptions rule" applies.]
[Rule "offer items to writing a paragraph about rule" applies.]
[Rule "use initial appearance in room descriptions rule" applies.]
[Rule "describe what's on scenery supporters in room descriptions rule" applies.]
[Rule "describe what's on mentioned supporters in room descriptions rule" applies.]
[Rule "initial appearance on supporters rule" applies.]
[Rule "don't mention player's supporter in room descriptions rule" applies.]
[Rule "don't mention scenery in room descriptions rule" applies.]
[Rule "don't mention undescribed items in room descriptions rule" applies.]
[Rule "set pronouns from items in room descriptions rule" applies.]
[Rule "offer items to writing a paragraph about rule" applies.]
[Rule "use initial appearance in room descriptions rule" applies.]
It's a shockingly blue flagpole.

On the blue pole is a pride flag.

[Rule "describe what's on scenery supporters in room descriptions rule" applies.]
[Rule "describe what's on mentioned supporters in room descriptions rule" applies.]
[Rule "you-can-also-see rule" applies.]
[Rule "check new arrival rule" applies.]
[Rule "after stage rule" applies.]
[Rule "investigate player's awareness after action rule" applies.]
[Rule "report stage rule" applies.]
[Rule "other people looking rule" applies.]
[Rule "last specific action-processing rule" applies.]
[looking - succeeded]

[Rule "A first turn sequence rule" applies.]
[Rule "every turn stage rule" applies.]
[Rule "A last turn sequence rule" applies.]
[Rule "notify score changes rule" applies.]

* * *

>look
Garden
There is an alarmingly blue flagpole here.

You can also see a pride flag here.

>get flagpole
You can't see any such thing.

>take pole
That's fixed in place.

>x pole
There is a blue pole here, but there's no flag on it.
.

>get flag
Taken.

>hang flag from pole
The pride flag is on the blue pole.

>x flag
A rainbow-colored pride flag.

>x
(the blue pole)
A pride flag is hanging limply near the bottom of the blue pole.
.

>raise flag
You raise the flag to the top of the pole. A pride flag is waving in the breeze at the top of the blue pole.
.

* * *

Garden
An Interactive Fiction
Release 1 / Serial number 210310 / Inform 7 build 6M62 (I6/v6.34 lib 6/12N) SD

Garden
There is an alarmingly blue flagpole here.

You can also see a pride flag here.

>look at flagpole
You can't see any such thing.

>look at blue
But there's no flag on it.
.

>look
Garden
It's a shockingly blue flagpole.

You can also see a pride flag here.

>put pride on flagpole
You can't see any such thing.

>get pride
Taken.

>hang pride
The pride flag is on the blue pole.

>look at blue
A pride flag is hanging limply near the bottom.

>raise flag
You raise the flag to the top of the pole.

>look at blue
A pride flag is waving in the breeze at the top.

>rules
Rules tracing now switched on. Type "rules off" to switch it off again, or "rules all" to include even rules which do not apply.

>look at blue
[Rule "declare everything initially unmentioned rule" applies.]
[Rule "announce items from multiple object lists rule" applies.]
[Rule "set pronouns from items from multiple object lists rule" applies.]
[Rule "before stage rule" applies.]
[Rule "can't act in the dark rule" applies.]
[Rule "instead stage rule" applies.]
[Rule "instead of examining a flagpole ( called fp )" applies.]
A pride flag is waving in the breeze at the top.

[Rule "A first turn sequence rule" applies.]
[Rule "every turn stage rule" applies.]
[Rule "A last turn sequence rule" applies.]
[Rule "notify score changes rule" applies.]

* * *

Garden
An Interactive Fiction
Release 1 / Serial number 210310 / Inform 7 build 6M62 (I6/v6.34 lib 6/12N) SD

Garden
There is an alarmingly blue flagpole here.

You can also see a pride flag here.

>press up
You must name something more substantial.

>x flagpole
It's a white flagpole with no flag. There are buttons on it.

>x button
You can't see any such thing.

>x up button
I only understood you as far as wanting to examine up.

>press up button
You can't see any such thing.

>press down  button
You can't see any such thing.

>look
Garden
A white flagpole, which has rusted and been repainted many times, stands nearby. It has a white box with two buttons on it.

You can also see a stone bench here.

>x flagpole
It's a white flagpole with no flag. There are buttons on it.

* * *

>i
You are carrying nothing.

>l
Garden
There is an alarmingly blue flagpole here.

You can also see a pride flag here.

>get flag
Taken.

* * *

>look
Garden
There is an alarmingly blue flagpole here.

On the blue pole is a pride flag.

>x pole
A pride flag is waving in the breeze at the top of the blue pole.
.

>raise flag to x
I only understood you as far as wanting to raise the pride flag.

* * *

>push up button
With an audible thunk, a motor comes to life and the flag creaks up the flagpole all the way to the top.

>push down
(the down button)
You hear the hum of a motor, and the flag moves down a bit. The flagpole has a flag fluttering proudly fat half-mast in honor of Uncle Rob and his service to America.

* * *

Garden
An Interactive Fiction
Release 1 / Serial number 210310 / Inform 7 build 6M62 (I6/v6.34 lib 6/12N) SD

Garden
There is an alarmingly blue flagpole here.

You can also see a pride flag here.

>test me
(Testing.)

>[1] put flag on flagpole
The flagpole now has a flag hanging limply near the bottom.

>[2] get flag
Taken.

>[3] put flag on flagpole
The flagpole now has a flag hanging limply near the bottom.

>[4] press down button
There is just a click.

>[5] press up
(the up button)
With an audible thunk, a motor comes to life and the flag creaks up the flagpole all the way to the top.

>[6] press down
(the down button)
You hear the hum of a motor, and the flag moves down a bit. The flagpole has a flag fluttering proudly fat half-mast in honor of Uncle Rob and his service to America.

>[7] x flagpole
It's a white flagpole with a flag fluttering proudly fat half-mast in honor of Uncle Rob and his service to America. There are buttons on it.

On the flagpole is a flag.

>[8] push down
(the down button)
You hear the hum of a motor, and the flag moves down a bit. The flagpole has a flag hanging limply near the bottom.

>[9] x flagpole
It's a white flagpole with a flag hanging limply near the bottom. There are buttons on it.

On the flagpole is a flag.

>[10] push up
(the up button)
With an audible thunk, a motor comes to life and the flag creaks up the flagpole all the way to the top.

>[11] take flag
The flag is too high to reach.

>push up
(the up button)
You hear a brief buzz but nothing else happens.

>push down
(the down button)
There is just a click.

>push up
(the up button)
You hear a brief buzz but nothing else happens.

>x pole
It's a white flagpole with a flag waving in the breeze at the top. It has a white box with two buttons on it.

>get flag
The flag is too high to reach.

You already have that.

>x pole
It's a white flagpole with a flag waving in the breeze at the top. It has a white box with two buttons on it.

* * *

>x polke
You can't see any such thing.

>x pole
It's a white flagpole with a flag waving in the breeze at the top. There are buttons on it.

On the flagpole is a flag.

>x box
The flagpole's rope enters a white metal box with two buttons.

>x up
(the up button)
It's a black plastic button with the word Up etched into it. The etching was once filled with white paint, but that's mostly gone now.

>press up
(the up button)
You hear a brief buzz but nothing else happens.

>x up
(the up button)
It's a black plastic button with the word Up etched into it. The etching was once filled with white paint, but that's mostly gone now.

>x buttons
It's a black plastic button with the word Up etched into it. The etching was once filled with white paint, but that's mostly gone now.

>x button
Which do you mean, the up button or the down button?

>up
It's a black plastic button with the word Up etched into it. The etching was once filled with white paint, but that's mostly gone now.

>x box
The flagpole's rope enters a white metal box with two buttons.

>get buttons
That seems to be a part of the white box.

* * *

Garden
An Interactive Fiction
Release 1 / Serial number 210310 / Inform 7 build 6M62 (I6/v6.34 lib 6/12N) SD

Garden
There is an alarmingly blue flagpole here.

You can also see a pride flag here.

>x bench
From this restful location you get a nice view of the harbor.

>sit on bench
You get onto the stone bench.

>stand
You get off the stone bench.

Garden
A white flagpole, which has rusted and been repainted many times, stands in the center of the garden. 

You can also see a stone bench here.

>sit on bench
You get onto the stone bench.

>look
Garden (on the stone bench)
A white flagpole, which has rusted and been repainted many times, stands in the center of the garden.

>x bench
From this restful location you get a nice view of the harbor.

>x harbor
Beyond the beach, the harbor stretches off to the south, filled with boats, lobster pots, and seagulls.

>i
You are carrying:
  a flag
  an oyster

>put oyster on flagpole
It would be disrespectful to hang the oyster from the flagpole.

>put flag on flagpole
The flagpole now has a flag hanging limply near the bottom.

>raise flag
That's not a verb I recognise.

>raise flag to top
That's not a verb I recognise.

>raise flag flag
That's not a verb I recognise.

>raise flag flagpole
That's not a verb I recognise.

>get flag
Taken.

>put flag on flagpole
The flagpole now has a flag hanging limply near the bottom.

>remove flat from flagpole
You can't see any such thing.

>remove flag from flagpole
Taken.

>x flagpole
It's a white flagpole a flag hanging limply near the bottom.
.

* * *

Garden
An Interactive Fiction
Release 1 / Serial number 210310 / Inform 7 build 6M62 (I6/v6.34 lib 6/12N) SD

Garden
There is an alarmingly blue flagpole here.

You can also see a pride flag here.

>x flagpole
It's a white flagpole with no flag. There are buttons on it.

>x buttons
You can't see any such thing.

>push up button
You can't see any such thing.

>x buttons
You can't see any such thing.

>x up
You see nothing unexpected in that direction.

>x up button
I only understood you as far as wanting to examine up.

>x box
You can't see any such thing.

* * *

Garden
An Interactive Fiction
Release 1 / Serial number 210310 / Inform 7 build 6M62 (I6/v6.34 lib 6/12N) SD

Garden
There is an alarmingly blue flagpole here.

You can also see a pride flag here.

>x pole.
There is a blue pole here, but there's no flag on it.
.

>get flag
Taken.

* * *

>put flag on pole
You put the pride flag on the blue pole.

>x pole
A pride flag is hanging limply near the bottom of the blue pole.
.

>raise flag
You raise the flag to the top of the pole. A pride flag is waving in the breeze at the top of the blue pole.
.

>x pole
A pride flag is waving in the breeze at the top of the blue pole.
.

>lower flag
You lower the flag a bit. A pride flag is fluttering proudly at half-mast on the blue pole.
.

* * *

>lower flag
You lower the flag a bit. A pride flag is hanging limply near the bottom of the blue pole.
.

>x pole
A pride flag is hanging limply near the bottom of the blue pole.
.

>x flag
A rainbow-colored pride flag.

>x pole
A pride flag is hanging limply near the bottom of the blue pole.
.

>actions
Actions listing on.

>x pole
[examining the blue pole]
A pride flag is hanging limply near the bottom of the blue pole.
.
[examining the blue pole - failed]