sink
An Interactive Fiction by Kent Quirk
Release 1 / Serial number 210314 / Inform 7 build 6M62 (I6/v6.34 lib 6/12N) SD

kitchen
You can see an empty white sink and a bucket of water here.

>look
kitchen
You can see a bucket of water here.

>x sink
You can't see any such thing.

>x whitesink
The whitesink offers a ready supply of water.

>pour bucket into sink
You can't see any such thing.

>pour bucket into whitesink
You dump out the bucket into the whitesinkand it goes down the drain.

>x whitesink
The whitesink offers a ready supply of water.

>x bucket
The empty bucket contains only a trace of water at the bottom.

>fill bucket from whitesink
(first taking the bucket)
You fill the bucket up with water from the whitesink.

>pour water into sink
You can't see any such thing.

* * *

sink
An Interactive Fiction by Kent Quirk
Release 1 / Serial number 210314 / Inform 7 build 6M62 (I6/v6.34 lib 6/12N) SD

kitchen
You can see an empty white sink and a bucket of water here.

>plug drain
the white sink is plugged.

>fill bucket
(first taking the bucket)
The bucket cannot contain any more than it already holds.

>pour bucket into sink
The white sink cannot contain any more than it already holds.

>x sink
The white sink is plugged and has some water in it.

>unplug sink
the empty white sink is unplugged.

>pour bucket into sink
You dump out the bucket into the white sink and it goes down the drain.

>plug drain
the empty white sink is plugged.

>x sink
The empty white sink contains only a trace of water at the bottom.

>fill bucket
No more water remains in the white sink.

* * *

>plug drain
the white sink is plugged.

>plug the drain
the white sink is now plugged.

* * *

sink
An Interactive Fiction by Kent Quirk
Release 1 / Serial number 210314 / Inform 7 build 6M62 (I6/v6.34 lib 6/12N) SD

kitchen
You can see an empty white sink and a bucket of water here.

>plug sink
the empty white sink is plugged.

>pour bucket into sink
(first taking the bucket)

>x sing
You can't see any such thing.

>x sink
The white sink The sink is plugged. It has some water in it.

* * *

>pour bucket into sink
(first taking the bucket)

>x sink
The empty white sink contains only a trace of water at the bottom.

>x bucket
The bucket is full of water.

>empty bucket into sink
You pour water into the white sink, leaving the bucket empty. It is less than half full of water.

>fill bucket
You fill the bucket with water from the white sink, leaving the white sink empty.

>unplug sink
You unplug the empty white sink.

>empty bucket into sink
You dump out the bucket into the white sink and water goes down the drain.

>fill bucket
You fill the bucket up with water from the faucet.

>plug sink
the empty white sink is plugged.

>empty bucket into sink
You pour water into the white sink, leaving the bucket empty. It is less than half full of water.

>fill bucket from faucet
You fill the bucket up with water from the faucet.

>empty bucket into sink
You pour water into the white sink, leaving the bucket empty. It is about half full of water.

>fill bucket from faucet
You fill the bucket up with water from the faucet.

>empty bucket into sink
You pour water into the white sink, leaving the bucket empty. It is more than half full of water.

>fill bucket from faucet
You fill the bucket up with water from the faucet.

>empty bucket into sink
You pour water into the white sink, leaving the bucket empty. It is nearly full of water.

>fill bucket from faucet
You fill the bucket up with water from the faucet.

>empty bucket into sink
You pour water into the white sink, leaving the bucket empty.

>x sink
The white sink is full of water.

>fill bucket from faucet
You fill the bucket up with water from the faucet.

>empty bucket into sink
The white sink cannot contain any more than it already holds.

>unplug sink
You unplug it and it empties swiftly.

* * *

sink
An Interactive Fiction by Kent Quirk
Release 1 / Serial number 210314 / Inform 7 build 6M62 (I6/v6.34 lib 6/12N) SD

kitchen
You can see an empty white sink and a bucket of water here.

>pour bucket into sink
You dump out the bucket into the white sink and it goes down the drain.

>fill bucket
(first taking the bucket)
You fill the bucket up with water from the white sink.

>plug sink
the white sink is now plugged.

>pour bucket into sink
You pour water into the white sink, leaving the bucket empty.

>look
kitchen

>x sink
The white sink is plugged and has some water in it.

* * *

sink
An Interactive Fiction by Kent Quirk
Release 1 / Serial number 210314 / Inform 7 build 6M62 (I6/v6.34 lib 6/12N) SD

kitchen
You can see an empty white sink and a bucket of water here.

>pour water into sink
(the bucket of water into the white sink)
You dump out the bucket into the white sinkand it goes down the drain.