bike
An Interactive Fiction by Kent Quirk
Release 1 / Serial number 210323 / Inform 7 build 6M62 (I6/v6.34 lib 6/12N) SD

Garage
You can't quite believe what you're seeing. This is a Motobecane Super Mirage 10-speed bicycle, and it has to be at least 30 years old. This is the same brand and era as the first bike you ever owned. It probably just needs some tender loving care. And you're just right for the job.

On the old bike is the rear wheel (on which is the inflated black tire).

You can also see a front wheel, a flat red tire, a floor pump and an oil can here.

>actions
Actions listing on.

>clean bike
[rubbing the old bike]
You use quite a few wet wipes to get all the dust, mud, and grease off the frame, seat, and handlebars. However, the front wheel is missing and the chain is frozen with rust.

You rub the old bike.
[rubbing the old bike - succeeded]

* * *

>actions
Actions listing on.

>get on bike
[entering the old bike]
[(1) mounting the old bike]
It's not in riding condition yet.
[(1) mounting the old bike - failed the Check mounting a bicycle ( called the ride )]

[entering the old bike - failed the Check mounting a bicycle ( called the ride )]

>get off bike
[getting off the old bike]
[(1) dismounting]
You are not riding anything.
[(1) dismounting - failed the can't dismount when not mounted rule]

[getting off the old bike - failed the can't dismount when not mounted rule]

>put front wheel on bike
[putting the front wheel on the old bike]
(first taking the front wheel)
[(1) taking the front wheel - silently]
[(1) taking the front wheel - silently - succeeded]

You put the front wheel on the old bike.
[putting the front wheel on the old bike - succeeded]

>put red tire on front wheel
[putting the flat red tire on the front wheel]
You can't install a tire while the wheel is on the bike!
[putting the flat red tire on the front wheel - failed the Check putting a tire ( called the rubber ) on a bikewheel ( called the wheel )]

* * *

bike
An Interactive Fiction by Kent Quirk
Release 1 / Serial number 210323 / Inform 7 build 6M62 (I6/v6.34 lib 6/12N) SD

Garage
You can't quite believe what you're seeing. This is a Motobecane Super Mirage 10-speed bicycle, and it has to be at least 30 years old. This is the same brand and era as the first bike you ever owned. It probably just needs some tender loving care. And you're just right for the job.

On the old bike is the rear wheel (on which is the inflated black tire).

You can also see a front wheel, a flat red tire, a floor pump and an oil can here.

>look at bike
You see an old Motobecane Super Mirage bicycle, but the front wheel is missing.

>pump up tire
I didn't understand that sentence.

>pump tire
What do you want to pump the flat tire with?

>pump tire with pump
(the flat tire with the floor pump)
A tire has to be mounted on a wheel before you can pump it.

>put tire on front wheel
(the flat tire on the front wheel)
You have to wrestle with it, but you manage to get the flat tire all the way onto the rim of the front wheel.

>x wheel
(the front wheel)
You see nothing special about the front wheel.

>pump tire with pump
(the flat tire with the floor pump)
You apply the hose to the tire stem, pump for a bit, and the tire inflates.

>pump flat tire with pump
You can't see any such thing.

>actions
Actions listing on.

>take tire off front wheel
You can't see any such thing.

>put flat tire on front wheel
You can't see any such thing.

* * *

bike
An Interactive Fiction by Kent Quirk
Release 1 / Serial number 210323 / Inform 7 build 6M62 (I6/v6.34 lib 6/12N) SD

Garage
You can't quite believe what you're seeing. This is a Motobecane Super Mirage 10-speed bicycle, and it has to be at least 30 years old. This is the same brand and era as the first bike you ever owned. It probably just needs some tender loving care. And you're just right for the job.

On the old bike is the rear wheel (on which is the inflated black tire).

You can also see a front wheel, a flat red tire, a floor pump and an oil can here.

>pump black tire
You can't pump up the inflated black tire because it already inflated.

>pump black tire with the red tire
You can't pump up the inflated black tire because it already inflated.

>pump red tire with the black tire
You can't pump up the flat red tire because it not on a wheel.

>put red tire on front wheel
(first taking the flat red tire)
You have to wrestle with it, but you manage to get the flat red tire all the way onto the rim of the front wheel.

You put the flat red tire on the front wheel.

>pump red tire with the black tire
The inflated black tire doesn't look much like an air pump.

>pump red tire
You apply the hose to the tire stem, pump for a bit, and the flat red tire inflates.

>deflate red tire
You press the stem and let the air out.

>look
Garage
You can't quite believe what you're seeing. This is a Motobecane Super Mirage 10-speed bicycle, and it has to be at least 30 years old. This is the same brand and era as the first bike you ever owned. It probably just needs some tender loving care. And you're just right for the job.

On the old bike is the rear wheel (on which is the inflated black tire).

You can also see a front wheel (on which is a flat red tire), a floor pump and an oil can here.

>put front wheel on bike
(first taking the front wheel)
You put the front wheel on the old bike.

>x bike
You see an old Motobecane Super Mirage bicycle, but the front wheel is flat, the chain is frozen with rust and it is very dirty.

>pump front wheel
You pump for a bit, and the flat red tire inflates.

* * *

bike
An Interactive Fiction by Kent Quirk
Release 1 / Serial number 210323 / Inform 7 build 6M62 (I6/v6.34 lib 6/12N) SD

Garage
You can't quite believe what you're seeing. This is a Motobecane Super Mirage 10-speed bicycle, and it has to be at least 30 years old. This is the same brand and era as the first bike you ever owned. It probably just needs some tender loving care. And you're just right for the job.

On the old bike is the rear wheel (on which is the inflated black tire).

You can also see a front wheel, a flat red tire, a floor pump and an oil can here.

>put front wheel on bike
(first taking the front wheel)
You put the front wheel on the old bike.

>put red tire on rear wheel
You can't install a tire while the wheel is on the bike!

>put red tire on front wheel
You can't install a tire while the wheel is on the bike!

>take rear wheel
Taken.

>put red tire on rear wheel
You can't put a second tire on the rear wheel.

>put rear wheel on bike
You put the rear wheel on the old bike.

>put front wheel on bike
(first taking the front wheel)
You put the front wheel on the old bike.

>x bike
You see an old Motobecane Super Mirage bicycle, but the front wheel is without a tire, the chain is frozen with rust and it is very dirty.

>take front wheel
Taken.

>put red tire on front wheel
(first taking the flat red tire)
You have to wrestle with it, but you manage to get the flat red tire all the way onto the rim of the front wheel.

You put the flat red tire on the front wheel.

>inflate red tire
You apply the hose to the tire stem, pump for a bit, and the flat red tire inflates.

>put wheel on bike
(the front wheel on the old bike)
You put the front wheel on the old bike.

>x bike
You see an old Motobecane Super Mirage bicycle, but the chain is frozen with rust and it is very dirty.

>lubricate chain
What do you want to lubricate the chain with?

>lubricate chain with oil can
You carefully apply a drop of oil to each joint. The chain is now operating smoothly.

>x bike
You see an old Motobecane Super Mirage bicycle, but it is very dirty.

>clean bike
You use quite a few wet wipes to get all the dust, mud, and grease off the frame, seat, and handlebars. It looks amazing now.

You rub the old bike.

>clean bike
It's looking good already!

* * *

>put front wheel on bike
(first taking the front wheel)
You put the front wheel on the old bike.

>x bike
On the old bike are a rim, a rusty chain and a rear wheel (on which is an inflated tire).

>take rusty chain off bike
Taken.

>i
You are carrying:
  a rusty chain

>take rim
You can't see any such thing.

>take wheel
Which do you mean, the rim or the rear wheel?

>take front wheel
Taken.

>put front tire on front wheel
(first taking the flat tire)
You put the flat tire on the rim.

>look
Garage
You can't quite believe what you're seeing. This is a Motobecane Super Mirage 10-speed bicycle, and it has to be at least 30 years old. This is the same brand and era as the first bike you ever owned. It's missing the front wheel, the chain is rusted, and it probably needs some tender loving care.

You're just right for the job.

On the old bike is a rear wheel (on which is an inflated tire).

You can also see a floor pump here.

>i
You are carrying:
  a rim
    a flat tire
  a rusty chain

* * *

bike
An Interactive Fiction by Kent Quirk
Release 1 / Serial number 210323 / Inform 7 build 6M62 (I6/v6.34 lib 6/12N) SD

Garage
You can't quite believe what you're seeing. This is a Motobecane Super Mirage 10-speed bicycle, and it has to be at least 30 years old. This is the same brand and era as the first bike you ever owned. It probably just needs some tender loving care. And you're just right for the job.

On the old bike is the rear wheel (on which is the inflated black tire).

You can also see a front wheel, a flat red tire, a floor pump and an oil can here.

>put red tire on the wheel
(the front wheel)
You have to wrestle with it, but you manage to get the flat red tire all the way onto the rim of the front wheel.

>showme wheel
(the front wheel)
front wheel - bikewheel
    flat red tire - tire
location: in the Garage
singular-named, improper-named; unlit, inedible, portable; list grouping key: none
printed name: "front wheel"
printed plural name: "bikewheels"
indefinite article: none
description: none
initial appearance: none
carrying capacity: 100

>pump wheel with pump
(the front wheel with the floor pump)
the flat red tire the floor pump You apply the hose to the tire stem, pump for a bit, and the inflated red tire inflates.

>take red tire
You can't get an inflated tire off a wheel.

>undo
Garage
[Previous turn undone.]

>take red tire off the wheel
(the front wheel)
You can't get an inflated tire off a wheel.

>put front wheel on the bike
(first taking the front wheel)
You put the front wheel on the old bike.

>x bike
You see an old Motobecane Super Mirage bicycle, but the chain is frozen with rust.

>take rusty chain
You can't see any such thing.

>x bike
You see an old Motobecane Super Mirage bicycle, but the chain is frozen with rust.

>take chain
(the new chain)
Taken.

>take chain
(the old chain)
Taken.

>x bikee
You can't see any such thing.

>x bike
You see an old Motobecane Super Mirage bicycle, but the chain is missing.

>put good chain on bikee
You can't see any such thing.

>put good chain on bike
You can't see any such thing.

>x bikee
You can't see any such thing.

* * *

>x bike
You see an old Motobecane Super Mirage bicycle, but the chain is missing.

>x bad chain
You can't see any such thing.

>x chain
Which do you mean, the old chain or the new chain?

>x old chain
rusty old chain

>x new chain
 new chain

* * *

bike
An Interactive Fiction by Kent Quirk
Release 1 / Serial number 210323 / Inform 7 build 6M62 (I6/v6.34 lib 6/12N) SD

Garage
You can't quite believe what you're seeing. This is a Motobecane Super Mirage 10-speed bicycle, and it has to be at least 30 years old. This is the same brand and era as the first bike you ever owned. It probably just needs some tender loving care. And you're just right for the job.

On the old bike is the rear wheel (on which is the inflated black tire).

You can also see a front wheel, a flat red tire, a floor pump and an oil can here.

>put the flat tire on the front wheel
You can't see any such thing.

>x front wheel
You see nothing special about the front wheel.

>x bike
On the old bike are the bad chain and the rear wheel (on which is an inflated tire).

* * *

bike
An Interactive Fiction by Kent Quirk
Release 1 / Serial number 210323 / Inform 7 build 6M62 (I6/v6.34 lib 6/12N) SD

Garage
You can't quite believe what you're seeing. This is a Motobecane Super Mirage 10-speed bicycle, and it has to be at least 30 years old. This is the same brand and era as the first bike you ever owned. It probably just needs some tender loving care. And you're just right for the job.

On the old bike is the rear wheel (on which is the inflated black tire).

You can also see a front wheel, a flat red tire, a floor pump and an oil can here.

>rules
Rules tracing now switched on. Type "rules off" to switch it off again, or "rules all" to include even rules which do not apply.

>clean bike
[Rule "declare everything initially unmentioned rule" applies.]
[Rule "announce items from multiple object lists rule" applies.]
[Rule "set pronouns from items from multiple object lists rule" applies.]
[Rule "before stage rule" applies.]
[Rule "instead stage rule" applies.]
[Rule "investigate player's awareness before action rule" applies.]
[Rule "player aware of his own actions rule" applies.]
[Rule "check stage rule" applies.]
[Rule "Check rubbing a bicycle ( called the bike )" applies.]
[Rule "can't rub another person rule" applies.]
[Rule "carry out stage rule" applies.]
[Rule "Carry out rubbing a bicycle ( called the ride )" applies.]
You use quite a few wet wipes to get all the dust, mud, and grease off the frame, seat, and handlebars. However, the front wheel is missing and the chain is frozen with rust.
[Rule "after stage rule" applies.]
[Rule "investigate player's awareness after action rule" applies.]
[Rule "report stage rule" applies.]
[Rule "last specific action-processing rule" applies.]

[Rule "A first turn sequence rule" applies.]
[Rule "every turn stage rule" applies.]
[Rule "A last turn sequence rule" applies.]
[Rule "notify score changes rule" applies.]

>ride bike
[Rule "declare everything initially unmentioned rule" applies.]
[Rule "announce items from multiple object lists rule" applies.]
[Rule "set pronouns from items from multiple object lists rule" applies.]
[Rule "before stage rule" applies.]
[Rule "instead stage rule" applies.]
[Rule "investigate player's awareness before action rule" applies.]
[Rule "player aware of his own actions rule" applies.]
[Rule "check stage rule" applies.]
[Rule "can't mount when mounted on an animal rule" applies.]
[Rule "can't mount when mounted on a vehicle rule" applies.]
[Rule "can't mount something unrideable rule" applies.]
[Rule "can't mount something carried rule" applies.]
[Rule "can't enter something carried rule" applies.]
[Rule "can't mount something unreachable rule" applies.]
[Rule "implicitly pass through other barriers rule" applies.]
[Rule "carry out stage rule" applies.]
[Rule "standard mounting rule" applies.]
[Rule "after stage rule" applies.]
[Rule "investigate player's awareness after action rule" applies.]
[Rule "report stage rule" applies.]
[Rule "standard report mounting rule" applies.]
You mount the old bike.
[Rule "initialise locale description rule" applies.]
[Rule "find notable locale objects rule" applies.]
[Rule "standard notable locale objects rule" applies.]
[Rule "interesting locale paragraphs rule" applies.]
[Rule "don't mention player's supporter in room descriptions rule" applies.]
[Rule "don't mention scenery in room descriptions rule" applies.]
[Rule "don't mention undescribed items in room descriptions rule" applies.]
[Rule "set pronouns from items in room descriptions rule" applies.]
[Rule "offer items to writing a paragraph about rule" applies.]
[Rule "use initial appearance in room descriptions rule" applies.]
[Rule "describe what's on scenery supporters in room descriptions rule" applies.]
[Rule "describe what's on mentioned supporters in room descriptions rule" applies.]
[Rule "initial appearance on supporters rule" applies.]
[Rule "don't mention player's supporter in room descriptions rule" applies.]
[Rule "don't mention scenery in room descriptions rule" applies.]
[Rule "don't mention undescribed items in room descriptions rule" applies.]
[Rule "set pronouns from items in room descriptions rule" applies.]
[Rule "offer items to writing a paragraph about rule" applies.]

[Rule "use initial appearance in room descriptions rule" applies.]
[Rule "describe what's on scenery supporters in room descriptions rule" applies.]
[Rule "describe what's on mentioned supporters in room descriptions rule" applies.]
[Rule "you-can-also-see rule" applies.]
On the old bike you can see the rear wheel (on which is the inflated black tire).

[Rule "last specific action-processing rule" applies.]
[Rule "A first turn sequence rule" applies.]
[Rule "every turn stage rule" applies.]
[Rule "A last turn sequence rule" applies.]
[Rule "notify score changes rule" applies.]

>rules off
[Rule "declare everything initially unmentioned rule" applies.]
Rules tracing now switched off. Type "rules" to switch it on again.

>get on bike
You are already riding the old bike.

>n
You can't go that way.

>get off
You dismount the old bike.

Garage
You can't quite believe what you're seeing. This is a Motobecane Super Mirage 10-speed bicycle, and it has to be at least 30 years old. This is the same brand and era as the first bike you ever owned. It probably just needs some tender loving care. And you're just right for the job.

On the old bike is the rear wheel (on which is the inflated black tire).

You can also see a front wheel, a flat red tire, a floor pump and an oil can here.

>get on
You mount the old bike.

On the old bike you can see the rear wheel (on which is the inflated black tire).

>get off
You dismount the old bike.

Garage
You can't quite believe what you're seeing. This is a Motobecane Super Mirage 10-speed bicycle, and it has to be at least 30 years old. This is the same brand and era as the first bike you ever owned. It probably just needs some tender loving care. And you're just right for the job.

On the old bike is the rear wheel (on which is the inflated black tire).

You can also see a front wheel, a flat red tire, a floor pump and an oil can here.

>actions
Actions listing on.

>get on
[entering the old bike]
[(1) mounting the old bike]
You mount the old bike.

On the old bike you can see the rear wheel (on which is the inflated black tire).

[(1) mounting the old bike - succeeded]

[entering the old bike - succeeded]

* * *

bike
An Interactive Fiction by Kent Quirk
Release 1 / Serial number 210323 / Inform 7 build 6M62 (I6/v6.34 lib 6/12N) SD

Garage
You can't quite believe what you're seeing. This is a Motobecane Super Mirage 10-speed bicycle, and it has to be at least 30 years old. This is the same brand and era as the first bike you ever owned. It probably just needs some tender loving care. And you're just right for the job.

On the old bike is the rear wheel (on which is the inflated black tire).

You can also see a front wheel, a flat red tire, a floor pump and an oil can here.

>showme black tire
inflated black tire - tire
location: on the rear wheel on the old bike in the Garage
singular-named, improper-named; unlit, inedible, portable; inflated
list grouping key: none
printed name: "inflated black tire"
printed plural name: "tires"
indefinite article: "the"
description: none
initial appearance: none
color: "black"

>x red tire
You see nothing special about the flat red tire.

>pump red tire with pump
check: the flat red tire the floor pump A tire has to be mounted on a wheel before you can pump it.

>put red tire on wheel
(the front wheel)
You have to wrestle with it, but you manage to get the flat red tire all the way onto the rim of the front wheel.

>x bike
You see an old Motobecane Super Mirage bicycle, but the front wheel is missing.

>put front wheel on bike
(first taking the front wheel)
You put the front wheel on the old bike.

>x bike
You see an old Motobecane Super Mirage bicycle, but the front wheel is missing.

>pump front wheel
What do you want to pump the front wheel with?

>pump front wheel with pump
check: the front wheel the floor pump is wheel
the front wheel the floor pump 
*** Run-time problem P10: Since the front wheel is not allowed the property "inflated", it is against the rules to try to use it.

You apply the hose to the tire stem, pump for a bit, and the front wheel inflates.

>showme red tire
flat red tire - tire
location: in the Garage
singular-named, improper-named; unlit, inedible, portable; flat, pumpable
list grouping key: none
printed name: "flat red tire"
printed plural name: "tires"
indefinite article: none
description: none
initial appearance: none
color: "red"

>showme front wheel
front wheel - bikewheel
location: on the old bike in the Garage
singular-named, improper-named; unlit, inedible, portable, handled; list grouping key: none
printed name: "front wheel"
printed plural name: "bikewheels"
indefinite article: none
description: none
initial appearance: none
carrying capacity: 100

>look at front wheel
You see nothing special about the front wheel.

>x front wheel
You see nothing special about the front wheel.

>x bike
You see an old Motobecane Super Mirage bicycle, but the front wheel is missing.

* * *

bike
An Interactive Fiction by Kent Quirk
Release 1 / Serial number 210323 / Inform 7 build 6M62 (I6/v6.34 lib 6/12N) SD

Garage
You can't quite believe what you're seeing. This is a Motobecane Super Mirage 10-speed bicycle, and it has to be at least 30 years old. This is the same brand and era as the first bike you ever owned. It probably just needs some tender loving care. And you're just right for the job.

On the old bike is the rear wheel (on which is the inflated black tire).

You can also see a front wheel, a flat red tire, a floor pump and an oil can here.

>showme wheel
(the front wheel)
front wheel - bikewheel
location: in the Garage
singular-named, improper-named; unlit, inedible, portable; list grouping key: none
printed name: "front wheel"
printed plural name: "bikewheels"
indefinite article: none
description: none
initial appearance: none
carrying capacity: 100

>put front tire on wheel
I didn't understand that sentence.

>put red tire on wheel
(the front wheel)
You have to wrestle with it, but you manage to get the flat red tire all the way onto the rim of the front wheel.

>showme wheel
(the front wheel)
front wheel - bikewheel
location: in the Garage
singular-named, improper-named; unlit, inedible, portable; list grouping key: none
printed name: "front wheel"
printed plural name: "bikewheels"
indefinite article: none
description: none
initial appearance: none
carrying capacity: 100

* * *

bike
An Interactive Fiction by Kent Quirk
Release 1 / Serial number 210323 / Inform 7 build 6M62 (I6/v6.34 lib 6/12N) SD

Garage
You can't quite believe what you're seeing. This is a Motobecane Super Mirage 10-speed bicycle, and it has to be at least 30 years old. This is the same brand and era as the first bike you ever owned. It probably just needs some tender loving care. And you're just right for the job.

On the old bike is the rear wheel (on which is the inflated black tire).

You can also see a front wheel, a flat red tire, a floor pump and an oil can here.

>take rear wheel
Taken.

>remove rear tire from rear wheel
You can't see any such thing.

* * *

bike
An Interactive Fiction by Kent Quirk
Release 1 / Serial number 210323 / Inform 7 build 6M62 (I6/v6.34 lib 6/12N) SD

Garage
You can't quite believe what you're seeing. This is a Motobecane Super Mirage 10-speed bicycle, and it has to be at least 30 years old. This is the same brand and era as the first bike you ever owned. It probably just needs some tender loving care. And you're just right for the job.

On the old bike is the rear wheel (on which is the inflated black tire).

You can also see a front wheel, a flat red tire, a floor pump and an oil can here.

>x bike
You see an old Motobecane Super Mirage bicycle, but the front wheel is missing, the chain is frozen with rust and it is very dirty.

>x chain
A rusty  chain.

* * *

>take old chain
I only understood you as far as wanting to take the old bike.

>x old chain
I only understood you as far as wanting to examine the old bike.

>put front wheel on bikee
You can't see any such thing.

>put front wheel on bike
(first taking the front wheel)
You put the front wheel on the old bike.

* * *

>x bike
You see an old Motobecane Super Mirage bicycle, but the front wheel is without a tire, the chain is frozen with rust and it is very dirty.

>put red tire on front wheele
I only understood you as far as wanting to put the flat red tire on the front wheel.

>put red tire on front wheel
You can't install a tire while the wheel is on the bike!

>remove front wheele
I only understood you as far as wanting to remove the front wheel.

>remove front wheel
You aren't wearing the front wheel.

>remove front wheel from bike
Taken.

>put red tire on front wheel
(first taking the flat red tire)
You have to wrestle with it, but you manage to get the flat red tire all the way onto the rim of the front wheel.

You put the flat red tire on the front wheel.

>put front wheel on bike
You put the front wheel on the old bike.

>inflate red tiree
I only understood you as far as wanting to inflate the flat red tire.

>inflate red tire
You apply the hose to the tire stem, pump for a bit, and the inflated red tire inflates.

>pump red tire with pump
A tire has to be mounted on a wheel before you can pump it.

>clean bike
You use quite a few wet wipes to get all the dust, mud, and grease off the frame, seat, and handlebars. However, the chain is frozen with rust.

You rub the old bike.

>actions
Actions listing on.

>clean bike
[rubbing the old bike]
It's looking good already!
[rubbing the old bike - failed the Check rubbing a bicycle ( called the bike )]

>actions off
Actions listing off.

>x bike
You see an old Motobecane Super Mirage bicycle, but the chain is frozen with rust.

>oil chain
What do you want to oil the chain with?

>oil chain with oil can
You carefully apply a drop of oil to each joint. The chain is now operating smoothly.

>x bike
You see an old Motobecane Super Mirage bicycle that's been fixed up and is ready to ride.

>lube chain
What do you want to lube the chain with?

>lubricate chain
What do you want to lubricate the chain with?

>lubricate chain with bike
No matter how hard you squeeze, you won't get oil from that.

>x bike
You see an old Motobecane Super Mirage bicycle that's been fixed up and is ready to ride.

>deflate rear wheel
You press the stem and let the air out.

>x rear wheel
On the rear wheel is the flat black tire.

>x bike
You see an old Motobecane Super Mirage bicycle, but the rear wheel is flat.

>pump up rear wheel
You pump for a bit, and the inflated black tire inflates.

>pump up black tire
A tire has to be mounted on a wheel before you can pump it.

>x black tire
You see nothing special about the inflated black tire.

>i
You are carrying nothing.

>x bike
You see an old Motobecane Super Mirage bicycle that's been fixed up and is ready to ride.

>showme bike
old bike - bicycle
    chain (part of old bike) - bikechain
    front wheel - bikewheel
        inflated red tire - tire
    rear wheel - bikewheel
        inflated black tire - tire
location: in the Garage
singular-named, improper-named; unlit, inedible, fixed in place; enterable; clean
list grouping key: none
printed name: "old bike"
printed plural name: "bicycles"
indefinite article: none
description: none
initial appearance: "You can't quite believe what you're seeing. This is a Motobecane Super Mirage 10-speed bicycle, and it has to be at least 30 years old. This is the same brand and era as the first bike you ever owned. It probably just needs some tender loving care. And you're just right for the job."
carrying capacity: 100