Light my fire
An Interactive Fiction by Kent Quirk
Release 1 / Serial number 210318 / Inform 7 build 6M62 (I6/v6.34 lib 6/12N) SD

Chilly Beach
There is a driftwood log sitting high on the beach. It looks like it's been here a while.

You see a bunch of seaweed, dried out by the sun.

There is a ring of rocks that would make an excellent firepit.

You can also see a matchbox (closed) here.

>actions
Actions listing on.

>put kelp in ring
[inserting the dried kelp into the ring of rocks]
(first taking the dried kelp)
[(1) taking the dried kelp - silently]
[(1) taking the dried kelp - silently - succeeded]

You put the dried kelp into the ring of rocks.
[inserting the dried kelp into the ring of rocks - succeeded]

>open box
[opening the matchbox]
(taking nothing first)
[(1) taking the matchbox]
Taken.
[(1) taking the matchbox - succeeded]

You open the matchbox, revealing three matches.
[opening the matchbox - succeeded]

>take match
[taking the match]
Taken.
[taking the match - succeeded]

>close box
[closing the matchbox]
You close the matchbox.
[closing the matchbox - succeeded]

>light match
[lighting up the match]
[(1) striking the match on the matchbox]
You carefully strike the match on the matchbox and it sparks to life.

[(1) striking the match on the matchbox - succeeded]

[lighting up the match - succeeded]

>light kelp
[lighting up the dried kelp]
[(1) lighting the dried kelp with the match]
[(2) setting fire to the dried kelp]
The dried kelp ignites.

[(2) setting fire to the dried kelp - succeeded]

[(1) lighting the dried kelp with the match - succeeded]

[lighting up the dried kelp - succeeded]

* * *

>actions
Actions listing on.

>take match
You can't see any such thing.

>open matchbox
[opening the matchbox]
(taking nothing first)
[(1) taking the matchbox]
Taken.
[(1) taking the matchbox - succeeded]

You open the matchbox, revealing three matches.
[opening the matchbox - succeeded]

>take match
[taking the match]
Taken.
[taking the match - succeeded]

>take match from matchbox
[removing the match from the matchbox]
[(1) taking the match]
Taken.
[(1) taking the match - succeeded]

[removing the match from the matchbox - succeeded]

* * *

Light my fire
An Interactive Fiction by Kent Quirk
Release 1 / Serial number 210318 / Inform 7 build 6M62 (I6/v6.34 lib 6/12N) SD

Chilly Beach
There is a driftwood log sitting high on the beach. It looks like it's been here a while.

You see a bunch of seaweed, dried out by the sun.

There is a ring of rocks that would make an excellent firepit.

You can also see a matchbox (closed) here.

>get kelp
Taken.

>put kelp in ring
You put the dried kelp into the ring of rocks.

>put driftwood in ring
(first taking the driftwood log)
You put the driftwood log into the ring of rocks.

>l
Chilly Beach
There is a ring of rocks that would make an excellent firepit.

You can see a matchbox (closed) here.

>get matchbox
Taken.

>open matchbox
You open the matchbox, revealing three matches.

>get match
Taken.

>take match
You already have one.

>close matchbox
You close the matchbox.

>strike match on matchbox
You carefully strike the match on the matchbox and it sparks to life.

>drop match in ring
You put the match into the ring of rocks.

The dried kelp ignites.

The match has stopped burning.

>l
Chilly Beach
There is a ring of rocks that would make an excellent firepit.

>x kelp
 is aflame.

>x
(the matchbox)
You see nothing special about the matchbox.

The driftwood log ignites.

>z
Time passes.

>z
Time passes.

The dried kelp has stopped burning.

>x kelp
 has burned out.

>x kelp
 has burned out.

>x ring
In the ring of rocks are a match, a driftwood log and some dried kelp.

>x match
 has burned out.

>x ring
In the ring of rocks are a match, a driftwood log and some dried kelp.

>take match
It crumbles to ashes as you touch it.

>i
You are carrying:
  a matchbox (closed)

>i match
I only understood you as far as wanting to take inventory.

>x match
You can't see any such thing.

>take driftwood
It's a bad idea to do that while it's burning.

The driftwood log has stopped burning.

>g
It crumbles to ashes as you touch it.

>x ring
In the ring of rocks are some dried kelp.

>take kelp
It crumbles to ashes as you touch it.

>undo
Chilly Beach
[Previous turn undone.]

>x ring
In the ring of rocks are some dried kelp.

>x kelp
 has burned out.

>take kelp
It crumbles to ashes as you touch it.

>x ring
The ring of rocks is empty.

>rules
Rules tracing now switched on. Type "rules off" to switch it off again, or "rules all" to include even rules which do not apply.

>x ring
[Rule "declare everything initially unmentioned rule" applies.]
[Rule "announce items from multiple object lists rule" applies.]
[Rule "set pronouns from items from multiple object lists rule" applies.]
[Rule "before stage rule" applies.]
[Rule "can't act in the dark rule" applies.]
[Rule "instead stage rule" applies.]
[Rule "investigate player's awareness before action rule" applies.]
[Rule "player aware of his own actions rule" applies.]
[Rule "check stage rule" applies.]
[Rule "carry out stage rule" applies.]
[Rule "standard examining rule" applies.]
[Rule "examine directions rule" applies.]
[Rule "examine containers rule" applies.]
The ring of rocks is empty.

[Rule "examine supporters rule" applies.]
[Rule "examine devices rule" applies.]
[Rule "examine undescribed things rule" applies.]
[Rule "after stage rule" applies.]
[Rule "investigate player's awareness after action rule" applies.]
[Rule "report stage rule" applies.]
[Rule "report other people examining rule" applies.]
[Rule "last specific action-processing rule" applies.]
[Rule "A first turn sequence rule" applies.]
[Rule "every turn stage rule" applies.]
[Rule "A last turn sequence rule" applies.]
[Rule "notify score changes rule" applies.]

>rules all
[Rule "declare everything initially unmentioned rule" applies.]
Rules tracing now switched to "all". Type "rules off" to switch it off again.

>x ring
[Rule "declare everything initially unmentioned rule" applies.]
[Rule "announce items from multiple object lists rule" applies.]
[Rule "set pronouns from items from multiple object lists rule" applies.]
[Rule "before stage rule" applies.]
[Rule "can't act in the dark rule" applies.]
[Rule "instead stage rule" applies.]
[Rule "Instead of examining a flammable item" does not apply (wrong action).]
[Rule "Instead of examining a flammable item ( called the fuel )" does not apply (wrong action).]
[Rule "investigate player's awareness before action rule" applies.]
[Rule "player aware of his own actions rule" applies.]
[Rule "check stage rule" applies.]
[Rule "carry out stage rule" applies.]
[Rule "standard examining rule" applies.]
[Rule "examine directions rule" applies.]
[Rule "examine containers rule" applies.]
The ring of rocks is empty.

[Rule "examine supporters rule" applies.]
[Rule "examine devices rule" applies.]
[Rule "examine undescribed things rule" applies.]
[Rule "after stage rule" applies.]
[Rule "investigate player's awareness after action rule" applies.]
[Rule "report stage rule" applies.]
[Rule "report other people examining rule" applies.]
[Rule "last specific action-processing rule" applies.]
[Rule "A first turn sequence rule" applies.]
[Rule "every turn stage rule" applies.]
[Rule "Every turn when a burning thing is visible" does not apply (wrong context).]
[Rule "A last turn sequence rule" applies.]
[Rule "notify score changes rule" applies.]

>rules off
[Rule "declare everything initially unmentioned rule" applies.]
Rules tracing now switched off. Type "rules" to switch it on again.

* * *

Light my fire
An Interactive Fiction by Kent Quirk
Release 1 / Serial number 210318 / Inform 7 build 6M62 (I6/v6.34 lib 6/12N) SD

Chilly Beach
There is a driftwood log sitting high on the beach. It looks like it's been here a while.

You see a bunch of seaweed, dried out by the sun.

There is a ring of rocks that would make an excellent firepit.

You can also see a matchbox (closed) here.

>get matchbox
Taken.

* * *

>get match
Taken.

>close matchbox
You close the matchbox.

>strike match
What do you want to strike the match on?

>strike match on matchbox
You carefully strike the match on the matchbox and it sparks to life.

>x match
The match is burning.

>x
What do you want to examine?

>g
You can't see any such thing.

>x match
The match is burning.

>put match in matchbox
The matchbox is closed.

>open matchbox
You open the matchbox, revealing two matches.

>put match in matchbox
You put the match into the matchbox.

The match is making it hot in the matchbox.

The match ignites.

The match ignites.

>x matchbox
In the matchbox are three matches.

The match is making it hot in the matchbox.

The match has stopped burning.

>x matches
You can't use multiple objects with that verb.

>x matchbox
In the matchbox are three matches.

The match is making it hot in the matchbox.

The match has already been burned.

The match has stopped burning.

The match has stopped burning.

>x matchbox
In the matchbox are three matches.

>get the driftwood
Taken.

>put the driftwood in the ring
You put the driftwood into the ring of rocks.

>ignite driftwood
That's not a verb I recognise.

* * *

>take match
Taken.

* * *

>get match
Taken.

>light kelp with match
You need a flame to start a fire.

>put kelp in ring
(first taking the dried kelp)
You put the dried kelp into the ring of rocks.

>light kelp with match
You need a flame to start a fire.

>i
You are carrying:
  a match
  a matchbox (open)
    two matches

>actions
Actions listing on.

>light kelp with match
[lighting the dried kelp with the match]
You need a flame to start a fire.
[lighting the dried kelp with the match - failed the Check lighting something with something]

>ignite kelp with match
[lighting the dried kelp with the match]
You need a flame to start a fire.
[lighting the dried kelp with the match - failed the Check lighting something with something]

>light match
[striking the match on the matchbox]
Safety first! Don't strike on an open matchbox!
[striking the match on the matchbox - failed the Check an actor striking something on something]

>light match on matchbox
[striking the match on the matchbox]
Safety first! Don't strike on an open matchbox!
[striking the match on the matchbox - failed the Check an actor striking something on something]

>close matchbox
[closing the matchbox]
You close the matchbox.
[closing the matchbox - succeeded]

>light match on matchbox
[striking the match on the matchbox]
You carefully strike the match on the matchbox and it sparks to life.
[striking the match on the matchbox - succeeded]

>ignite kelp with match
[lighting the dried kelp with the match]
[(1) setting fire to the dried kelp]
The dried kelp ignites.
[(1) setting fire to the dried kelp - succeeded]

[lighting the dried kelp with the match - succeeded]

[putting out the fire of the match]
The match has stopped burning.
[putting out the fire of the match - succeeded]

>ignite log with match
You can't see any such thing.

>ignite driftwoodwith match
I didn't understand that sentence.

>ignite driftwoodw ith match
I didn't understand that sentence.

>ignite driftwood with match
[lighting the driftwood with the match]
[(1) setting fire to the driftwood]
The driftwood ignites.
[(1) setting fire to the driftwood - succeeded]

[lighting the driftwood with the match - succeeded]

>l
[looking]
Chilly Beach
You can see a driftwood and a ring of rocks (in which is a dried kelp) here.

[looking - succeeded]

>x driftwood
[examining the driftwood]
 is aflame.
[examining the driftwood - failed]

[putting out the fire of the dried kelp]
The dried kelp has stopped burning.
[putting out the fire of the dried kelp - succeeded]

>x kelp
[examining the dried kelp]
It's seaweed, dried out by the sun. has burned out.
[examining the dried kelp - failed]

* * *

>ignite log with match
You can't see any such thing.

>l
[looking]
Chilly Beach
You can see a driftwood and a ring of rocks (in which is a dried kelp) here.

[looking - succeeded]

* * *

>get match
Taken.

>strike match
Safety first! Don't strike matches on an open box.

>look at match
The match is unlit.

>rules
Rules tracing now switched on. Type "rules off" to switch it off again, or "rules all" to include even rules which do not apply.

>actions
[Rule "declare everything initially unmentioned rule" applies.]
Actions listing on.

>look at match
[Rule "declare everything initially unmentioned rule" applies.]
[examining the match]
[Rule "announce items from multiple object lists rule" applies.]
[Rule "set pronouns from items from multiple object lists rule" applies.]
[Rule "before stage rule" applies.]
[Rule "can't act in the dark rule" applies.]
[Rule "instead stage rule" applies.]
[Rule "Instead of examining a match" applies.]
The match is unlit.
[examining the match - failed]

[Rule "A first turn sequence rule" applies.]
[Rule "every turn stage rule" applies.]
[Rule "A last turn sequence rule" applies.]
[Rule "notify score changes rule" applies.]

* * *

>get match
Taken.

>strike match on box
You can't see any such thing.

>strike match on matchbox
Safety first! Don't strike on an open matchbox!

>close matchbox
You close the matchbox.

* * *

>strike match on matchbox
You carefully strike the match on the matchbox and it sparks to life.

>i
You are carrying:
  a match
  a matchbox (closed)

>x match
The match is burning.

* * *

>showme match
match - match
location: carried by yourself in the Chilly Beach
singular-named, improper-named; unlit, inedible, portable, handled; ignited, unburnt; unstrikeable
list grouping key: none
printed name: "match"
printed plural name: "matches"
indefinite article: none
description: none
initial appearance: none
burn time: 2
ignition time: 0

>x match
The match is burning.

>i
You are carrying:
  a match
  a matchbox (closed)

* * *

>open matchbox
You open the matchbox, revealing three matches.

>strike match
(first taking the match)
Safety first! Don't strike on an open matchbox!

>close matchbox
You close the matchbox.

>strike match
You carefully strike the match on the matchbox and it sparks to life.

>i
You are carrying:
  a match
  a matchbox (closed)

The match has stopped burning.

>strike match on matchbox
The match is not something you can ignite that way.

>x match
 has burned out.

>x match
 has burned out.

>g
 has burned out.

>g
 has burned out.

* * *

>strike match
(first taking the match)
Safety first! Don't strike on an open matchbox!

>i
You are carrying:
  a matchbox (open)
    three matches

>get match
Taken.

* * *

>strike match
Safety first! Don't strike matches on an open box.

>close box
You can't see any such thing.

>close matchbox
You close the matchbox.

>strike match
You strike the match on the box and it's burning.

You switch the match on.

>x match
The match is burning.

>x match
The match is burning.

The match gets too close to your fingers and you blow it out.

* * *

>take match
You already have that.

>drop match
Dropped.

>take match
Taken.

>i
You are carrying:
  a match
  a matchbox (closed)

>rules
Rules tracing now switched on. Type "rules off" to switch it off again, or "rules all" to include even rules which do not apply.

>i
[Rule "declare everything initially unmentioned rule" applies.]
[Rule "announce items from multiple object lists rule" applies.]
[Rule "set pronouns from items from multiple object lists rule" applies.]
[Rule "before stage rule" applies.]
[Rule "instead stage rule" applies.]
[Rule "investigate player's awareness before action rule" applies.]
[Rule "player aware of his own actions rule" applies.]
[Rule "check stage rule" applies.]
[Rule "carry out stage rule" applies.]
[Rule "print empty inventory rule" applies.]
[Rule "print standard inventory rule" applies.]
You are carrying:
  a match
  a matchbox (closed)
[Rule "after stage rule" applies.]
[Rule "investigate player's awareness after action rule" applies.]
[Rule "report stage rule" applies.]

[Rule "report other people taking inventory rule" applies.]
[Rule "last specific action-processing rule" applies.]
[Rule "A first turn sequence rule" applies.]
[Rule "every turn stage rule" applies.]
[Rule "A last turn sequence rule" applies.]
[Rule "notify score changes rule" applies.]

>x match
[Rule "declare everything initially unmentioned rule" applies.]
[Rule "announce items from multiple object lists rule" applies.]
[Rule "set pronouns from items from multiple object lists rule" applies.]
[Rule "before stage rule" applies.]
[Rule "can't act in the dark rule" applies.]
[Rule "instead stage rule" applies.]
[Rule "Instead of examining a burnable item" applies.]
[Rule "standard examining rule" applies.]
[Rule "A first turn sequence rule" applies.]
[Rule "every turn stage rule" applies.]
[Rule "A last turn sequence rule" applies.]
[Rule "notify score changes rule" applies.]

>x matchbox
[Rule "declare everything initially unmentioned rule" applies.]
[Rule "announce items from multiple object lists rule" applies.]
[Rule "set pronouns from items from multiple object lists rule" applies.]
[Rule "before stage rule" applies.]
[Rule "can't act in the dark rule" applies.]
[Rule "instead stage rule" applies.]
[Rule "investigate player's awareness before action rule" applies.]
[Rule "player aware of his own actions rule" applies.]
[Rule "check stage rule" applies.]
[Rule "carry out stage rule" applies.]
[Rule "standard examining rule" applies.]
[Rule "examine directions rule" applies.]
[Rule "examine containers rule" applies.]
[Rule "examine supporters rule" applies.]
[Rule "examine devices rule" applies.]
[Rule "examine undescribed things rule" applies.]
You see nothing special about the matchbox.
[Rule "after stage rule" applies.]
[Rule "investigate player's awareness after action rule" applies.]
[Rule "report stage rule" applies.]

[Rule "report other people examining rule" applies.]
[Rule "last specific action-processing rule" applies.]
[Rule "A first turn sequence rule" applies.]
[Rule "every turn stage rule" applies.]
[Rule "A last turn sequence rule" applies.]
[Rule "notify score changes rule" applies.]

* * *

>open matchbox
You open the matchbox, revealing three matches.

>take match
Taken.

>i
You are carrying:
  a match
  a matchbox (open)
    two matches

>close matchbox
You close the matchbox.

* * *

>strike match
What do you want to strike the match on?

>strike match on matchbox
You strike the match on the box and it's burning.

>i
You are carrying:
  a match (providing light)
  a matchbox (closed)

>strike match on matchbox
It's already burning!

The match gets too close to your fingers and you drop it.

>strike match on matchbox
It was a match, not a lighter, and it's been used already. Get a new one.

>drop match
Dropped.

>get match
Taken.

* * *

>take match
Taken.

>take matche
You can't see any such thing.

>x matchbox
In the matchbox are two matches.

>i
You are carrying:
  a match
  a matchbox (open)
    two matches

>light match
You switch the match on.

* * *

Light my fire
An Interactive Fiction by Kent Quirk
Release 1 / Serial number 210318 / Inform 7 build 6M62 (I6/v6.34 lib 6/12N) SD

Chilly Beach
There is a driftwood log sitting high on the beach. It looks like it's been here a while.

You see a bunch of seaweed, dried out by the sun.

There is a ring of rocks that would make an excellent firepit.

You can also see a matchbox (closed) here.

>light kelp
It's not clear what that means.

>light kelp with matchbook
You can't see any such thing.

>open box
(taking the matchbox first)
Taken.

You open the matchbox, revealing three matches.

>drop box
Dropped.

>x box
In the matchbox are three matches.

>close box
You close the matchbox.

>open box
(taking the matchbox first)
Taken.

You open the matchbox, revealing three matches.

* * *

>drop box
Dropped.

>close box
You close the matchbox.

>rules
Rules tracing now switched on. Type "rules off" to switch it off again, or "rules all" to include even rules which do not apply.

* * *

>actions
[Rule "declare everything initially unmentioned rule" applies.]
Actions listing on.

>open box
[Rule "declare everything initially unmentioned rule" applies.]
[opening the matchbox]
[Rule "announce items from multiple object lists rule" applies.]
[Rule "set pronouns from items from multiple object lists rule" applies.]
[Rule "before stage rule" applies.]
[Rule "instead stage rule" applies.]
[Rule "investigate player's awareness before action rule" applies.]
[Rule "player aware of his own actions rule" applies.]
[Rule "check stage rule" applies.]
[Rule "Check an actor opening a matchbox while the actor does not carry a matchbox" applies.]
(taking the matchbox first)
[(1) taking the matchbox]
[Rule "announce items from multiple object lists rule" applies.]
[Rule "set pronouns from items from multiple object lists rule" applies.]
[Rule "before stage rule" applies.]
[Rule "instead stage rule" applies.]
[Rule "investigate player's awareness before action rule" applies.]
[Rule "player aware of his own actions rule" applies.]
[Rule "check stage rule" applies.]
[Rule "can't take yourself rule" applies.]
[Rule "can't take other people rule" applies.]
[Rule "can't take component parts rule" applies.]
[Rule "can't take people's possessions rule" applies.]
[Rule "can't take items out of play rule" applies.]
[Rule "can't take what you're inside rule" applies.]
[Rule "can't take what's already taken rule" applies.]
[Rule "can't take scenery rule" applies.]
[Rule "can only take things rule" applies.]
[Rule "can't take what's fixed in place rule" applies.]
[Rule "use player's holdall to avoid exceeding carrying capacity rule" applies.]
[Rule "can't exceed carrying capacity rule" applies.]
[Rule "carry out stage rule" applies.]
[Rule "standard taking rule" applies.]
[Rule "after stage rule" applies.]
[Rule "investigate player's awareness after action rule" applies.]
[Rule "report stage rule" applies.]
[Rule "standard report taking rule" applies.]
Taken.
[Rule "last specific action-processing rule" applies.]
[(1) taking the matchbox - succeeded]

[Rule "can't open unless openable rule" applies.]
[Rule "can't open what's locked rule" applies.]
[Rule "can't open what's already open rule" applies.]
[Rule "carry out stage rule" applies.]
[Rule "standard opening rule" applies.]
[Rule "after stage rule" applies.]
[Rule "investigate player's awareness after action rule" applies.]
[Rule "report stage rule" applies.]
[Rule "reveal any newly visible interior rule" applies.]
You open the matchbox, revealing three matches.
[Rule "last specific action-processing rule" applies.]
[opening the matchbox - succeeded]

[Rule "A first turn sequence rule" applies.]
[Rule "every turn stage rule" applies.]
[Rule "A last turn sequence rule" applies.]
[Rule "notify score changes rule" applies.]

* * *

Light my fire
An Interactive Fiction by Kent Quirk
Release 1 / Serial number 210318 / Inform 7 build 6M62 (I6/v6.34 lib 6/12N) SD

Chilly Beach
There is a driftwood log sitting high on the beach. It looks like it's been here a while.

You see a bunch of seaweed, dried out by the sun.

There is a ring of rocks that would make an excellent firepit.

You can also see a matchbox (closed) here.

>open box
(taking the matchbox first)
Taken.

You open the matchbox, revealing three matches.

>take match
Taken.

>close box
You close the matchbox.

>light match on box
You carefully strike the match on the matchbox and it sparks to life.

>light log with match
You should find a safe place to build a fire first.

>put log in ring
(first taking the driftwood log)
You put the driftwood log into the ring of rocks.

The match has stopped burning.

>open box
You open the matchbox, revealing two matches.

>take match
Taken.

>light match
Safety first! Don't strike on an open matchbox!

>close box
You close the matchbox.

>light match
You carefully strike the match on the matchbox and it sparks to life.

>light log with match
One match isn't enough to light the driftwood log. You'll need kindling.

>blow on match
It burns a little hotter.

The match has stopped burning.

* * *

Light my fire
An Interactive Fiction by Kent Quirk
Release 1 / Serial number 210318 / Inform 7 build 6M62 (I6/v6.34 lib 6/12N) SD

Chilly Beach
There is a driftwood log sitting high on the beach. It looks like it's been here a while.

You see a bunch of seaweed, dried out by the sun.

There is a ring of rocks that would make an excellent firepit.

You can also see a matchbox (closed) here.

>open matchbox
(taking nothing first)
Taken.

You open the matchbox, revealing three matches.

>look
Chilly Beach
You can see a driftwood, a dried kelp and a ring of rocks (empty) here.

>i
You are carrying:
  a matchbox (open)
    three matches

>drop matchbox
Dropped.

>take match
(taking nothing first)
Taken.

Taken.

>i
You are carrying:
  a match
  a matchbox (open)
    two matches

* * *

Light my fire
An Interactive Fiction by Kent Quirk
Release 1 / Serial number 210318 / Inform 7 build 6M62 (I6/v6.34 lib 6/12N) SD

Chilly Beach
There is a driftwood log sitting high on the beach. It looks like it's been here a while.

You see a bunch of seaweed, dried out by the sun.

There is a ring of rocks that would make an excellent firepit.

You can also see a matchbox (closed) here.

>take match
You can't see any such thing.

>open matchbox
(taking nothing first)
Taken.

You open the matchbox, revealing three matches.

>take match
Taken.

>take match
Taken.

>i
You are carrying:
  two matches
  a matchbox (open)
    a match

* * *

Light my fire
An Interactive Fiction by Kent Quirk
Release 1 / Serial number 210318 / Inform 7 build 6M62 (I6/v6.34 lib 6/12N) SD

Chilly Beach
There is a driftwood log sitting high on the beach. It looks like it's been here a while.

You see a bunch of seaweed, dried out by the sun.

There is a ring of rocks that would make an excellent firepit.

You can also see a matchbox (closed) here.

>take seaweed
Taken.

>take matchbox
Taken.

>i
You are carrying:
  a matchbox (closed)
  some dried kelp

>take log
Taken.

>put log in firepit
You put the driftwood log into the ring of rocks.

>put seaweed in firepit
You put the dried kelp into the ring of rocks.

>light match
You can't see any such thing.

>open matchbox
You open the matchbox, revealing three matches.

>take matches
There are none at all available!

>take match
Taken.

* * *

>light match
Safety first! Don't strike on an open matchbox!

>close matchbox
You close the matchbox.

>light match
You carefully strike the match on the matchbox and it sparks to life.

>throw match in firepit
You put the match into the ring of rocks.

>blow on keelp
You can't see any such thing.

>blow on kelp
It glows a little brighter.

The dried kelp ignites.

The match has stopped burning.

>blow on fire
That's not likely to help.

>look
Chilly Beach
There is a ring of rocks that would make an excellent firepit.

>x rirng
You can't see any such thing.

>x ring
In the ring of rocks are a match (burnt out), some dried kelp (burning) and a driftwood log (heating up).

The driftwood log ignites.

>blow on log
It burns a little hotter.

>x ring
In the ring of rocks are a match (burnt out), some dried kelp (nearly out) and a driftwood log (burning).

The dried kelp has stopped burning.

* * *

Light my fire
An Interactive Fiction by Kent Quirk
Release 1 / Serial number 210318 / Inform 7 build 6M62 (I6/v6.34 lib 6/12N) SD

Chilly Beach
There is a driftwood log sitting high on the beach. It looks like it's been here a while.

You see a bunch of seaweed, dried out by the sun.

There is a ring of rocks that would make an excellent firepit.

You can also see a matchbox (closed) here.

>test me
(Testing.)

>[1] get matchbox
Taken.

>[2] open matchbox
You open the matchbox, revealing three matches.

>[3] strike match
(on the matchbox)
(first taking the match)
Safety first! Don't strike on an open matchbox!

>[4] get match
You already have one.

>[5] close matchbox
You close the matchbox.

>[6] strike match
What do you want to strike the match on?

>[7] x match
.

>[8] g
.

>[9] g
.

>[10] g
.

>actions
Actions listing on.

>strike match
What do you want to strike the match on?

>close matchbo
You can't see any such thing.

>close matchbox
[closing the matchbox]
That's already closed.
[closing the matchbox - failed the can't close what's already closed rule]

>strike match
What do you want to strike the match on?

>i
[taking inventory]
You are carrying:
  a match
  a matchbox (closed)

[taking inventory - succeeded]

>rules
Rules tracing now switched on. Type "rules off" to switch it off again, or "rules all" to include even rules which do not apply.

>strike match
What do you want to strike the match on?

>strike match on match
[Rule "declare everything initially unmentioned rule" applies.]
[striking the match on the match]
[Rule "announce items from multiple object lists rule" applies.]
[Rule "set pronouns from items from multiple object lists rule" applies.]
[Rule "before stage rule" applies.]
[Rule "instead stage rule" applies.]
[Rule "investigate player's awareness before action rule" applies.]
[Rule "player aware of his own actions rule" applies.]
[Rule "check stage rule" applies.]
[Rule "Check an actor striking something on something" applies.]
The match is not rough enough to strike on.
[striking the match on the match - failed the Check an actor striking something on something]

[Rule "A first turn sequence rule" applies.]
[Rule "every turn stage rule" applies.]
[Rule "A last turn sequence rule" applies.]
[Rule "notify score changes rule" applies.]

>strike match on dritfwood
You can't see any such thing.

>strike match on driftwood
[Rule "declare everything initially unmentioned rule" applies.]
[striking the match on the driftwood]
[Rule "announce items from multiple object lists rule" applies.]
[Rule "set pronouns from items from multiple object lists rule" applies.]
[Rule "before stage rule" applies.]
[Rule "instead stage rule" applies.]
[Rule "investigate player's awareness before action rule" applies.]
[Rule "player aware of his own actions rule" applies.]
[Rule "check stage rule" applies.]
[Rule "Check an actor striking something on something" applies.]
The driftwood is not rough enough to strike on.
[striking the match on the driftwood - failed the Check an actor striking something on something]

[Rule "A first turn sequence rule" applies.]
[Rule "every turn stage rule" applies.]
[Rule "A last turn sequence rule" applies.]
[Rule "notify score changes rule" applies.]

* * *

>i
You are carrying:
  a match
  a matchbox (closed)

* * *

Light my fire
An Interactive Fiction by Kent Quirk
Release 1 / Serial number 210318 / Inform 7 build 6M62 (I6/v6.34 lib 6/12N) SD

Chilly Beach
There is a driftwood log sitting high on the beach. It looks like it's been here a while.

You see a bunch of seaweed, dried out by the sun.

There is a ring of rocks that would make an excellent firepit.

You can also see a matchbox (closed) here.

>x ring
The ring of rocks is empty.

>put driftwood in ring
(first taking the driftwood log)
You put the driftwood log into the ring of rocks.

>x ring
In the ring of rocks is a driftwood log
.

>put seaweed in ring
(first taking the dried kelp)
You put the dried kelp into the ring of rocks.

>x ring
In the ring of rocks are some dried kelp
 and a driftwood log
.

>get matchbox
Taken.

* * *

>take match
Taken.

>close box
You can't see any such thing.

* * *

>light match
You carefully strike the match on the matchbox and it sparks to life.

>light kelp
(first taking the dried kelp)
The dried kelp is not something you can ignite that way.

>drop kelp in ring
You put the dried kelp into the ring of rocks.

The match has stopped burning.

>open matchbox
You open the matchbox, revealing two matches.

>get match
Taken.

>i
You are carrying:
  a match (almost lit)

  a matchbox (open)
    a match (almost lit)

>drop match
Dropped.

* * *

>get match
Taken.

>get match
You already have one.

>close matchbox
You close the matchbox.

>light matchbox
The matchbox is not something you can ignite that way.

>light match
You carefully strike the match on the matchbox and it sparks to life.

>light kelp with match
The dried kelp ignites.

>x ring
In the ring of rocks are some dried kelp (burning)
 and a driftwood log
.

The match has stopped burning.

>x kelp
You see nothing special about the dried kelp.

>x log
You see nothing special about the driftwood log.

The driftwood log ignites.

>x ring
In the ring of rocks are some dried kelp (nearly out)
 and a driftwood log (burning)
.

The dried kelp has stopped burning.

>x ring
In the ring of rocks are some dried kelp (burnt out)
 and a driftwood log (burning)
.

>get log
It's a bad idea to do that while it's burning.

>get kelp
It crumbles to ashes as you touch it.