memories
An Interactive Fiction by Kent Quirk
Release 1 / Serial number 210308 / Inform 7 build 6M62 (I6/v6.34 lib 6/12N) SD

Bedroom
Bedroom description. The hallway is west.

You can see a cap here.

I had a poster of Kitt

I think you had to be a certain age

>showme bedroom
Bedroom - room
    yourself - person
singular-named, improper-named; lighted, visited
list grouping key: none
printed name: "Bedroom"
printed plural name: none
indefinite article: none
description: "Bedroom description. The hallway is west."
memoryKey: "bedroom"

* * *

memories
An Interactive Fiction by Kent Quirk
Release 1 / Serial number 210308 / Inform 7 build 6M62 (I6/v6.34 lib 6/12N) SD

Bedroom
Bedroom description. The hallway is west.

You can see a cap here.

I had a poster of Kitt

I think you had to be a certain age

>w
Hallway
A boring hallway. The kitchen is north; the bedroom is to the east.

>actions
Actions listing on.

>n
[going north]

kitchen
Kitchen description. South takes you back to the hallway.

You can see a knife here.

[going north - succeeded]

>s
[going south]

hallway
A boring hallway. The kitchen is north; the bedroom is to the east.

[going south - succeeded]

>rules
Rules tracing now switched on. Type "rules off" to switch it off again, or "rules all" to include even rules which do not apply.

* * *

>w
Hallway
A boring hallway. The kitchen is north; the bedroom is to the east.

>e
bedroom
Bedroom description. nothing.

>w
hallway
A boring hallway. nothing.

>s
You can't go that way.

>n
kitchen
Kitchen description. nothing.

* * *

>w
Hallway
A boring hallway. The kitchen is north; the bedroom is to the east.

>n
Kitchen
Kitchen description. South takes you back to the hallway.

You can see a knife here.

I used to sit here after school and do homework over a bowl of Captain Crunch.

>s
Hallway
A boring hallway. The kitchen is north; the bedroom is to the east.

>e
Bedroom
Bedroom description. The hallway is west.

You can see a cap here.

I had a poster of Kitt

I think you had to be a certain age

>wear cap
(first taking the cap)
You put on the cap.

>look
Bedroom
Bedroom description. The hallway is west.

I had a poster of Kitt

(I never liked that show.)

I think you had to be a certain age

>w
Hallway
A boring hallway. The kitchen is north; the bedroom is to the east.

>s
You can't go that way.

>n
Kitchen
Kitchen description. South takes you back to the hallway.

You can see a knife here.

I used to sit here after school and do homework over a bowl of Captain Crunch.

(That cereal always cut my mouth up.)

* * *

>s
Hallway
A boring hallway. The kitchen is north; the bedroom is to the east.

>look
hallway
A boring hallway. The kitchen is north; the bedroom is to the east.

>objects
That's not a verb I recognise.

>take all
You can't see any such thing.

>i
You are carrying nothing.

>n
kitchen
Kitchen description. South takes you back to the hallway.

You can see a knife here.

>i
You are carrying nothing.

>look
kitchen
Kitchen description. South takes you back to the hallway.

You can see a knife here.

>examine kitchen
You can't see any such thing.

>take knife
Taken.

>s;e
That's not a verb I recognise.

>s
hallway
A boring hallway. The kitchen is north; the bedroom is to the east.

>e
bedroom
Bedroom description. The hallway is west.

>take knife
You already have that.

>look
bedroom
Bedroom description. The hallway is west.

* * *

memories
An Interactive Fiction by Kent Quirk
Release 1 / Serial number 210308 / Inform 7 build 6M62 (I6/v6.34 lib 6/12N) SD

Bedroom
Bedroom description. The hallway is west.

You can see a cap here.

I had a poster of Kitt

I think you had to be a certain age

>wear cap
(first taking the cap)
You put on the cap.

>s
You can't go that way.

>w
Hallway
A boring hallway. The kitchen is north; the bedroom is to the east.

>n
Kitchen
Kitchen description. South takes you back to the hallway.

You can see a knife here.

I used to sit here after school and do homework over a bowl of Captain Crunch.

(That cereal always cut my mouth up.)

>x knife
It's a kitchen knife. It looks very well used, and it is probably wickedly sharp. You notice a gleam from its edge.

Uncle Rob gave me a really nice knife once.

(You lost it at scout camp.)

I ... lost it.

>doff hat
You can't see any such thing.

>doff cap
You take off the cap.

>x knife
It's a kitchen knife. It looks very well used, and it is probably wickedly sharp. You notice a gleam from its edge.

Uncle Rob gave me a really nice knife once.

I ... lost it.

>burn knife
This dangerous act would achieve little.

>x knife
It's a kitchen knife. It looks very well used, and it is probably wickedly sharp. You notice a gleam from its edge.

>s
Hallway
A boring hallway. The kitchen is north; the bedroom is to the east.

>w
You can't go that way.

>e
Bedroom
Bedroom description. The hallway is west.