You step into the Room of Bewilderment with the words of the host ringing in your ears: you can always ask for HELP.

Basics
An Interactive Fiction
Release 1 / Serial number 210321 / Inform 7 build 6M62 (I6/v6.34 lib 6/12N) SD

Room of Bewilderment
You're bewildered.
Exits are north and west.

You can see a panel of 57 brass buttons, a trap door, a lever marked DO NOT PULL, a brightly-gleaming sawblade and a sheet of instructions in Mandarin here.

>help
Room of Bewilderment
You can see a panel of 57 brass buttons, a trap door, a lever marked DO NOT PULL, a brightly-gleaming sawblade and a sheet of instructions in Mandarin here.

>look
Base of Mount Kosciusko
You stand at the base of Mount Kosciusko. (Type HELP to visit the help menus).

>look at me
As good-looking as ever.

>i
You are carrying nothing.

>n
You can't go that way.

>s
You can't go that way.

>e
You can't go that way.

>w
You can't go that way.

>d
You can't go that way.

>u
You can't go that way.

>help
Base of Mount Kosciusko
You stand at the base of Mount Kosciusko. (Type HELP to visit the help menus).

>flame-o
That's not a verb I recognise.

>flame
That's not a verb I recognise.

>flameo
That's not a verb I recognise.

>cast
That's not a verb I recognise.

>hnt
That's not a verb I recognise.

>hint
That's not a verb I recognise.

>climb
What do you want to climb?

>mount
You can't see any such thing.

>climb mount
You can't see any such thing.

>cast flame at mount
That's not a verb I recognise.

>help
Base of Mount Kosciusko
You stand at the base of Mount Kosciusko. (Type HELP to visit the help menus).

* * *

You step into the Room of Bewilderment with the words of the host ringing in your ears: you can always ask for HELP.

Basics
An Interactive Fiction
Release 1 / Serial number 210321 / Inform 7 build 6M62 (I6/v6.34 lib 6/12N) SD

Room of Bewilderment
You're bewildered.
Exits are north and west.

You can see a panel of 57 brass buttons, a trap door, a lever marked DO NOT PULL, a brightly-gleaming sawblade and a sheet of instructions in Mandarin here.

>n
other room

The only exit goes south.

>s
Room of Bewilderment
You're still bewildered.
Exits go north and west.

You can see a panel of 57 brass buttons, a trap door, a lever marked DO NOT PULL, a brightly-gleaming sawblade and a sheet of instructions in Mandarin here.

>help
Room of Bewilderment
You're still bewildered.
The only exit leads north.

You can see a panel of 57 brass buttons, a trap door, a lever marked DO NOT PULL, a brightly-gleaming sawblade and a sheet of instructions in Mandarin here.

* * *

>s
Room of Bewilderment
You're still bewildered.
Exits go north and west.

You can see a panel of 57 brass buttons, a trap door, a lever marked DO NOT PULL, a brightly-gleaming sawblade and a sheet of instructions in Mandarin here.

>w
third room
It looks the same, only different.
The only exit leads east.

>e
Room of Bewilderment
You're still bewildered.
Exits lead north and west.

You can see a panel of 57 brass buttons, a trap door, a lever marked DO NOT PULL, a brightly-gleaming sawblade and a sheet of instructions in Mandarin here.

* * *

You step into the Room of Bewilderment with the words of the host ringing in your ears: you can always ask for HELP.

Basics
An Interactive Fiction
Release 1 / Serial number 210321 / Inform 7 build 6M62 (I6/v6.34 lib 6/12N) SD

Room of Bewilderment
You're bewildered.
Exits are north and west.

You can see a panel of 57 brass buttons, a trap door, a lever marked DO NOT PULL, a brightly-gleaming sawblade and a sheet of instructions in Mandarin here.

>s
You can't go that way.

>n
other room

The only exit leads south to the Room of Bewilderment.

>s
Room of Bewilderment
You're still bewildered.
Exits go north to the other room and west.

You can see a panel of 57 brass buttons, a trap door, a lever marked DO NOT PULL, a brightly-gleaming sawblade and a sheet of instructions in Mandarin here.

>w
third room
It looks the same, only different.
The only exit goes east to the Room of Bewilderment.

>n
You can't go that way.

>e
Room of Bewilderment
You're still bewildered.
Exits lead north to the other room and west to the third room.

You can see a panel of 57 brass buttons, a trap door, a lever marked DO NOT PULL, a brightly-gleaming sawblade and a sheet of instructions in Mandarin here.