keychain
An Interactive Fiction by Kent Quirk
Release 1 / Serial number 210308 / Inform 7 build 6M62 (I6/v6.34 lib 6/12N) SD

hallway
You can see a crate (closed) and a brass key here.

>i
You are carrying:
  a keyring
    a brass key
    a shiny key
  a totebag

>unlock crate
You lack a key that fits the crate.

>key
That's not a verb I recognise.

>i
You are carrying:
  a keyring
    a brass key
    a shiny key
  a totebag

>x keychain
You can't see any such thing.

>open crate
(first unlocking the crate)
You lack a key that fits the crate.

>take coins
You can't see any such thing.

>i
You are carrying:
  a keyring
    a brass key
    a shiny key
  a totebag

* * *

keychain
An Interactive Fiction by Kent Quirk
Release 1 / Serial number 210308 / Inform 7 build 6M62 (I6/v6.34 lib 6/12N) SD

hallway
You can see a crate (closed) and a brass key here.

>open crate
(first unlocking the crate)
You lack a key that fits the crate.

>take key
(the brass key)
You put the brass key on the keyring.

>i
You are carrying:
  a keyring
    a brass key
    a shiny key
  a totebag

>open crate
(first unlocking the crate)
(with the brass key)
You open the crate, revealing gold coins.

>x brass key
You see nothing special about the brass key.

The brass key unlocks the crate.

>take coins
you ain't got it, kid.

>drop coins
Dropped.

>rules
Rules tracing now switched on. Type "rules off" to switch it off again, or "rules all" to include even rules which do not apply.

>actions
[Rule "declare everything initially unmentioned rule" applies.]
Actions listing on.

>take coins
[Rule "declare everything initially unmentioned rule" applies.]
[taking gold coins]
[Rule "announce items from multiple object lists rule" applies.]
[Rule "set pronouns from items from multiple object lists rule" applies.]
[Rule "before stage rule" applies.]
[Rule "keychain-aware carrying requirements rule" applies.]
[Rule "instead stage rule" applies.]
[Rule "investigate player's awareness before action rule" applies.]
[Rule "player aware of his own actions rule" applies.]
[Rule "check stage rule" applies.]
[Rule "can't take yourself rule" applies.]
[Rule "can't take other people rule" applies.]
[Rule "can't take component parts rule" applies.]
[Rule "can't take people's possessions rule" applies.]
[Rule "can't take items out of play rule" applies.]
[Rule "can't take what you're inside rule" applies.]
[Rule "can't take what's already taken rule" applies.]
[Rule "can't take scenery rule" applies.]
[Rule "can only take things rule" applies.]
[Rule "can't take what's fixed in place rule" applies.]
[Rule "use player's holdall to avoid exceeding carrying capacity rule" applies.]
[Rule "can't exceed carrying capacity rule" applies.]
[Rule "carry out stage rule" applies.]
[Rule "standard taking rule" applies.]
[Rule "after stage rule" applies.]
[Rule "After taking gold coins" applies.]
you ain't got it, kid.
[taking gold coins - succeeded]

[Rule "A first turn sequence rule" applies.]
[Rule "every turn stage rule" applies.]
[Rule "A last turn sequence rule" applies.]
[Rule "notify score changes rule" applies.]

* * *

keychain
An Interactive Fiction by Kent Quirk
Release 1 / Serial number 210308 / Inform 7 build 6M62 (I6/v6.34 lib 6/12N) SD

hallway
You can see a crate (closed) and a brass key here.

>x keychain
On the keychain is a brass key.