This door is alarmed!
An Interactive Fiction by Kent Quirk
Release 1 / Serial number 210305 / Inform 7 build 6M62 (I6/v6.34 lib 6/12N) SD

Side Porch
You're on the side porch. The number is painted on a slate panel next to the door. The door leads west.

This is a navy blue door that has been faded and peeled by a western exposure.

>actions
Actions listing on.

>rulees
That's not a verb I recognise.

>rules
Rules tracing now switched on. Type "rules off" to switch it off again, or "rules all" to include even rules which do not apply.

>unlock door
(with the brass key)
[Rule "declare everything initially unmentioned rule" applies.]
[unlocking the blue door with the brass key]
[Rule "announce items from multiple object lists rule" applies.]
[Rule "set pronouns from items from multiple object lists rule" applies.]
[Rule "before stage rule" applies.]
[Rule "instead stage rule" applies.]
[Rule "investigate player's awareness before action rule" applies.]
[Rule "player aware of his own actions rule" applies.]
[Rule "check stage rule" applies.]
[Rule "can't unlock without a lock rule" applies.]
[Rule "can't unlock what's already unlocked rule" applies.]
[Rule "can't unlock without the correct key rule" applies.]
[Rule "carry out stage rule" applies.]
[Rule "standard unlocking rule" applies.]
[Rule "after stage rule" applies.]
[Rule "investigate player's awareness after action rule" applies.]
[Rule "report stage rule" applies.]
[Rule "standard report unlocking rule" applies.]
You unlock the blue door.
[Rule "last specific action-processing rule" applies.]
[unlocking the blue door with the brass key - succeeded]

[Rule "A first turn sequence rule" applies.]
[Rule "every turn stage rule" applies.]
[Rule "A last turn sequence rule" applies.]
[Rule "notify score changes rule" applies.]

>open door
[Rule "declare everything initially unmentioned rule" applies.]
[opening the blue door]
[Rule "announce items from multiple object lists rule" applies.]
[Rule "set pronouns from items from multiple object lists rule" applies.]
[Rule "before stage rule" applies.]
[Rule "instead stage rule" applies.]
[Rule "investigate player's awareness before action rule" applies.]
[Rule "player aware of his own actions rule" applies.]
[Rule "check stage rule" applies.]
[Rule "can't open unless openable rule" applies.]
[Rule "can't open what's locked rule" applies.]
[Rule "can't open what's already open rule" applies.]
[Rule "carry out stage rule" applies.]
[Rule "standard opening rule" applies.]
[Rule "after stage rule" applies.]
[Rule "investigate player's awareness after action rule" applies.]
[Rule "report stage rule" applies.]
[Rule "reveal any newly visible interior rule" applies.]
[Rule "standard report opening rule" applies.]
You open the blue door.
[Rule "last specific action-processing rule" applies.]
[opening the blue door - succeeded]

[Rule "A first turn sequence rule" applies.]
[Rule "every turn stage rule" applies.]
[Rule "A last turn sequence rule" applies.]
[Rule "notify score changes rule" applies.]

* * *

>actions
Actions listing on.

>test me
(Testing.)

>[1] unlock door
(with the brass key)
[unlocking the blue door with the brass key]
You unlock the blue door.
[unlocking the blue door with the brass key - succeeded]

>[2] open door
[opening the blue door]
You open the blue door.
[opening the blue door - succeeded]

>[3] w
[going west]
You can't go that way.
[going west - failed the can't go that way rule]

>[4] look at alarm
[examining the alarm box]
It's the control panel for a burglar alarm. It has a red LED labeled "ARMED" which is lit, and a green LED labeled "ALERT" which is dark. There is also a display which is currently blank.

[examining the alarm box - succeeded]

>[5] type 123 on keyboard
[keypad-typing "123 on keyboard"]
The alarm emits a brief chirp after the first 4 digits but that's all.

[keypad-typing "123 on keyboard" - succeeded]

>[6] east
[going east]

Side Porch
You're on the side porch. The number is painted on a slate panel next to the door.

You can see a blue door here.

[going east - succeeded]

>[7] look
[looking]
Side Porch
You're on the side porch. The number is painted on a slate panel next to the door.

You can see a blue door here.

[looking - succeeded]

>[8] west
[going west]
An ominous voice says "5".[going west - succeeded]

>[9] type 12345
[keypad-typing "12345"]
The alarm emits a brief chirp after the first 4 digits but that's all.

[keypad-typing "12345" - succeeded]

An ominous voice says "4".
>[10] type 9999
[keypad-typing "9999"]
The keypad emits a sad chirp but nothing else happens.

[keypad-typing "9999" - succeeded]

>[11] x key
[examining the brass key]
You see nothing special about the brass key.

[examining the brass key - succeeded]

An ominous voice says "3".
>[12] x alarm
[examining the alarm box]
It's the control panel for a burglar alarm. It has a red LED labeled "ARMED" which is lit, and a green LED labeled "ALERT" which is flashing. There is also a display which is currently 3.

[examining the alarm box - succeeded]

>[13] read key
[examining the brass key]
You see nothing special about the brass key.

[examining the brass key - succeeded]

An ominous voice says "2".
>[14] x alarm
[examining the alarm box]
It's the control panel for a burglar alarm. It has a red LED labeled "ARMED" which is lit, and a green LED labeled "ALERT" which is flashing. There is also a display which is currently 2.

[examining the alarm box - succeeded]

>[15] type 1789
[keypad-typing "1789"]
The alarm goes silent and dark.

[keypad-typing "1789" - succeeded]

>[16] x alarm
[examining the alarm box]
It's the control panel for a burglar alarm. It has a red LED labeled "ARMED" which is not lit, and a green LED labeled "ALERT" which is dark. There is also a display which is currently blank.

[examining the alarm box - succeeded]

>restart
[restarting the game]
Are you sure you want to restart?

>yest
Please answer yes or no.

>yes
This door is alarmed!
An Interactive Fiction by Kent Quirk
Release 1 / Serial number 210305 / Inform 7 build 6M62 (I6/v6.34 lib 6/12N) SD

Mud Room
This is an entrance hallway with a tiled floor. There is an alarm box on the wall next to the side door.

You can see a blue door here.

>unlock door
(with the brass key)
You unlock the blue door.

>open door
You open the blue door.

>w
You can't go that way.

>x box
It's the control panel for a burglar alarm. It has a red LED labeled "ARMED" which is lit, and a green LED labeled "ALERT" which is dark. There is also a display which is currently blank.

>look
Mud Room
This is an entrance hallway with a tiled floor. There is an alarm box on the wall next to the side door.

You can see a blue door here.

>e
Side Porch
You're on the side porch. The number is painted on a slate panel next to the door.

You can see a blue door here.

>look
Side Porch
You're on the side porch. The number is painted on a slate panel next to the door.

You can see a blue door here.

>x
(the brass key)
You see nothing special about the brass key.

>x number
It's a bit of rough slate, hanging from a nail, with a painting of an anchor and "1789" in big numbers.

>read number
It's a bit of rough slate, hanging from a nail, with a painting of an anchor and "1789" in big numbers.

>restart
Are you sure you want to restart?

>yes
This door is alarmed!
An Interactive Fiction by Kent Quirk
Release 1 / Serial number 210305 / Inform 7 build 6M62 (I6/v6.34 lib 6/12N) SD

Mud Room
This is an entrance hallway with a tiled floor. There is an alarm box on the wall next to the side door.

You can see a blue door here.

>open door
It seems to be locked.

>unlock door
(with the brass key)
You unlock the blue door.

>x door
You see nothing special about the blue door.

>look
Mud Room
This is an entrance hallway with a tiled floor. There is an alarm box on the wall next to the side door.

You can see a blue door here.

* * *

This door is alarmed!
An Interactive Fiction by Kent Quirk
Release 1 / Serial number 210305 / Inform 7 build 6M62 (I6/v6.34 lib 6/12N) SD

Side Porch
You're on the side porch. The number is painted on a slate panel next to the door. The door leads west.

This is a navy blue door that has been faded and peeled by a western exposure.

>open
(the brass key)
It isn't something you can open.

>open door
It seems to be locked.

>look around
You can't see any such thing.

>l
Side Porch
You're on the side porch. The number is painted on a slate panel next to the door.

This is a navy blue door that has been faded and peeled by a western exposure.

>x
(the brass key)
You see nothing special about the brass key.

>x door
It's a blue door.

>i
You are carrying:
  a brass key

>unlock door with key
You unlock the blue door.

>open door
You open the blue door.

>enter house
You need to be near a keypad to type on it.

>go west
An ominous voice says "5".

>l
Mud Room
This is an entrance hallway with a tiled floor. There is an alarm box on the wall next to the side door.

This is a navy blue door that has been faded and peeled by a western exposure.

An ominous voice says "4".

>x alarm
It's the control panel for a burglar alarm. It has a numeric keypad, a red LED labeled "ARMED" which is lit, and a green LED labeled "ALERT" which is flashing. There is also a display which is currently 4.

>turn
(the brass key)
Nothing obvious happens.

An ominous voice says "3".

>turn off alarm
It isn't something you can switch.

>go
You'll have to say which compass direction to go in.

An ominous voice says "2".

>east
Side Porch
You're on the side porch. The number is painted on a slate panel next to the door.

This is a navy blue door that has been faded and peeled by a western exposure.

>x slate panel
It's a bit of rough slate, hanging from a nail, with a painting of an anchor and "1789" in big numbers.

An ominous voice says "1".

>run away
You can't see any such thing.

>go east
You can't go that way.

>east
You can't go that way.

An ominous voice says "0".

>disarm
I didn't understand that sentence.

>look
Side Porch
You're on the side porch. The number is painted on a slate panel next to the door.

This is a navy blue door that has been faded and peeled by a western exposure.

>west
An ominous voice says "0".

>l
Mud Room
This is an entrance hallway with a tiled floor. There is an alarm box on the wall next to the side door.

This is a navy blue door that has been faded and peeled by a western exposure.

The alarm triggers with an earsplitting wail.  The neighbors will certainly call the cops.

>enter code
You need to enter a numeric code.

>enter code 1789
The alarm goes silent and dark.

>whew
That's not a verb I recognise.

>disarm alarm
You need to enter a numeric code.

>disarm alarm with 1787
The keypad emits a sad chirp but nothing else happens.

* * *

This door is alarmed!
An Interactive Fiction by Kent Quirk
Release 1 / Serial number 210305 / Inform 7 build 6M62 (I6/v6.34 lib 6/12N) SD

Side Porch
You're on the side porch. The number is painted on a slate panel next to the door. The door leads west.

This is a navy blue door that has been faded and peeled by a western exposure.

>open door
It seems to be locked.

* * *

>open door
You open the blue door.

>in
Mud Room
This is an entrance hallway with a tiled floor. There is an alarm box on the wall next to the side door.

You can see a blue door here.

* * *

This door is alarmed!
An Interactive Fiction by Kent Quirk
Release 1 / Serial number 210305 / Inform 7 build 6M62 (I6/v6.34 lib 6/12N) SD

Side Porch
You're on the side porch. The number is painted on a slate panel next to the door. The door leads west.

This is a navy blue door that has been faded and peeled by a western exposure.

>rules
Rules tracing now switched on. Type "rules off" to switch it off again, or "rules all" to include even rules which do not apply.

* * *

This door is alarmed!
An Interactive Fiction by Kent Quirk
Release 1 / Serial number 210305 / Inform 7 build 6M62 (I6/v6.34 lib 6/12N) SD

Side Porch
You're on the side porch. The number is painted on a slate panel next to the door. The door leads west.

This is a navy blue door that has been faded and peeled by a western exposure.

>test me
(Testing.)

>[1] unlock door
(with the brass key)
You unlock the blue door.

>[2] open door
You open the blue door.

>[3] w
An ominous voice from the alarm box says "5".
>[4] look at alarm
It's the control panel for a burglar alarm. It has a red LED labeled "ARMED" which is lit, and a green LED labeled "ALERT" which is flashing. There is also a display which is currently 5.

An ominous voice from the alarm box says "4".
>[5] type 123 on keyboard
The alarm emits a brief chirp after the first 4 digits but that's all.

>[6] type 12345
The alarm emits a brief chirp after the first 4 digits but that's all.

An ominous voice from the alarm box says "3".
>[7] type 9999
The keypad emits a sad chirp but nothing else happens.

>[8] x key
You see nothing special about the brass key.

An ominous voice from the alarm box says "2".
>[9] x alarm
It's the control panel for a burglar alarm. It has a red LED labeled "ARMED" which is lit, and a green LED labeled "ALERT" which is flashing. There is also a display which is currently 2.

>[10] read key
You see nothing special about the brass key.

An ominous voice from the alarm box says "1".
>[11] x alarm
It's the control panel for a burglar alarm. It has a red LED labeled "ARMED" which is lit, and a green LED labeled "ALERT" which is flashing. There is also a display which is currently 1.

>[12] type 1789
The alarm goes silent and dark.

>[13] x alarm
It's the control panel for a burglar alarm. It has a red LED labeled "ARMED" which is not lit, and a green LED labeled "ALERT" which is dark. There is also a display which is currently blank.

* * *

This door is alarmed!
An Interactive Fiction by Kent Quirk
Release 1 / Serial number 210305 / Inform 7 build 6M62 (I6/v6.34 lib 6/12N) SD

Side Porch
You're on the side porch. The number is painted on a slate panel next to the door. The door leads west.

This is a navy blue door that has been faded and peeled by a western exposure.

>type 123
You need to be near a keypad to type on it.

>enter 123
You can't see any such thing.

>unlock door
(with the brass key)
You unlock the blue door.

* * *

>open door
You open the blue door.

>in
An ominous voice says "5".

>inside
An ominous voice says "4".

* * *

>west
You can't go that way.

An ominous voice says "3".

>out
But you aren't in anything at the moment.

>east
Side Porch
You're on the side porch. The number is painted on a slate panel next to the door. The door leads west.

This is a navy blue door that has been faded and peeled by a western exposure.

An ominous voice says "2".

>go in
An ominous voice says "2".

>actions
Actions listing on.

>in
[going inside]
[going inside - failed]

An ominous voice says "1".

>east
[going east]

Side Porch
You're on the side porch. The number is painted on a slate panel next to the door. The door leads west.

This is a navy blue door that has been faded and peeled by a western exposure.

[going east - succeeded]

>west
[going west]
An ominous voice says "1".[going west - succeeded]

* * *

This door is alarmed!
An Interactive Fiction by Kent Quirk
Release 1 / Serial number 210305 / Inform 7 build 6M62 (I6/v6.34 lib 6/12N) SD

Side Porch
You're on the side porch. The number is painted on a slate panel next to the door. The door leads west.

This is a navy blue door that has been faded and peeled by a western exposure.

>unlock door
(with the brass key)
You unlock the blue door.

* * *

>open door
You open the blue door.

>e
You can't go that way.

>w
Mud Room
This is an entrance hallway with a tiled floor. There is an alarm box on the wall next to the side door.

You can see a blue door here.

>x alarm
The alarm box is beeping once a second. There is a display on the box that is showing a countdown. It currently reads 5.

>x alarm
The alarm box is beeping once a second. There is a display on the box that is showing a countdown. It currently reads 5.

>unlock door
(with the brass key)
That's unlocked at the moment.

>e
Side Porch
You're on the side porch. The house number is displayed in brass digits on the door.

You can see a blue door here.

>actions
Actions listing on.

>w
[going west]

Mud Room
This is an entrance hallway with a tiled floor. There is an alarm box on the wall next to the side door.

You can see a blue door here.

[going west - succeeded]

* * *

>open door
You open the blue door.

>in
A tinny voice says "INTRUSION ALERT -- 5".
Mud Room
This is an entrance hallway with a tiled floor. There is an alarm box on the wall next to the side door. The side door leads out to the east.

This is a navy blue door that has been faded and peeled by a western exposure.

>look
Mud Room
This is an entrance hallway with a tiled floor. There is an alarm box on the wall next to the side door. The side door leads out to the east.

This is a navy blue door that has been faded and peeled by a western exposure.

A tinny voice says "INTRUSION ALERT -- 4".

>out
Side Porch
You're on the side porch. The number is painted on a slate panel next to the door. The door leads west.

This is a navy blue door that has been faded and peeled by a western exposure.

>go out
An ominous voice says "3".

>look
Side Porch
You're on the side porch. The number is painted on a slate panel next to the door. The door leads west.

This is a navy blue door that has been faded and peeled by a western exposure.

>actions
Actions listing on.

>out
[exiting]
[exiting - failed]

An ominous voice says "2".

>go out
[going outside]
[going outside - failed]

>in
[going inside]
[(1) going west]
An ominous voice says "2".[(1) going west - succeeded]

[going inside - succeeded]

>out
[exiting]
[(1) going east]

Side Porch
You're on the side porch. The number is painted on a slate panel next to the door. The door leads west.

This is a navy blue door that has been faded and peeled by a western exposure.

[(1) going east - succeeded]

[exiting - failed]

An ominous voice says "1".

* * *

>look
Mud Room
This is an entrance hallway with a tiled floor. There is an alarm box on the wall next to the side door. The side door leads out to the east.

This is a navy blue door that has been faded and peeled by a western exposure.

A tinny voice says "INTRUSION ALERT -- 4".

>x alarm
It's the control panel for a burglar alarm. It has a small speaker, a numeric keypad, a red LED labeled "ARMED" which is lit, and a green LED labeled "ALERT" which is flashing. There is also a display that says "Enter Code to Disarm".

>enter code 1789
The alarm goes silent and dark.

>x alarm
It's the control panel for a burglar alarm. It has a small speaker, a numeric keypad, a red LED labeled "ARMED" which is not lit, and a green LED labeled "ALERT" which is dark. There is also a display that says "Enter Code to Arm".

>enter code 1789
You have re-armed the alarm system!

>out
Side Porch
You're on the side porch. The number is painted on a slate panel next to the door. The door leads west.

This is a navy blue door that has been faded and peeled by a western exposure.

>in
A tinny voice says "INTRUSION ALERT -- 5".
Mud Room
This is an entrance hallway with a tiled floor. There is an alarm box on the wall next to the side door. The side door leads out to the east.

This is a navy blue door that has been faded and peeled by a western exposure.

>x door
It's a door heading east to the outside.

A tinny voice says "INTRUSION ALERT -- 4".

>out
Side Porch
You're on the side porch. The number is painted on a slate panel next to the door. The door leads west.

This is a navy blue door that has been faded and peeled by a western exposure.

>x door
It's a blue door with a number next to it, heading in to the west.

A tinny voice says "INTRUSION ALERT -- 3".

>x number
It's a bit of rough slate, hanging from a nail, with a painting of an anchor and "1789" in big numbers.

>in
A tinny voice says "INTRUSION ALERT -- 3".
Mud Room
This is an entrance hallway with a tiled floor. There is an alarm box on the wall next to the side door. The side door leads out to the east.

This is a navy blue door that has been faded and peeled by a western exposure.

>enter code
You need to enter a numeric code.

A tinny voice says "INTRUSION ALERT -- 2".

>enter code 1789
The alarm goes silent and dark.

* * *

>in
A tinny voice says "INTRUSION ALERT -- 5".
Mud Room
This is an entrance hallway with a tiled floor. There is an alarm box on the wall next to the side door. The side door leads out to the east.

This is a navy blue door that has been faded and peeled by a western exposure.

>x
(the brass key)
You see nothing special about the brass key.

>l
Mud Room
This is an entrance hallway with a tiled floor. There is an alarm box on the wall next to the side door.

You can see a blue door here.

>x box
The alarm box is beeping once a second. There is a display on the box that is showing a countdown. It currently reads 5.

>out
Side Porch
You're on the side porch. The house number is displayed in brass digits on the door.

You can see a blue door here.

>actions
Actions listing on.

>in
[going inside]
[going inside - succeeded]

>x
(the brass key)
[examining the brass key]
You see nothing special about the brass key.

[examining the brass key - succeeded]

>x
(the brass key)
[examining the brass key]
You see nothing special about the brass key.

[examining the brass key - succeeded]

* * *

>open door
You open the blue door.

>w
A tinny voice says "INTRUSION ALERT -- 5".
Mud Room
This is an entrance hallway with a tiled floor. There is an alarm box on the wall next to the side door. The side door leads out to the east.

This is a navy blue door that has been faded and peeled by a western exposure.

>type 1234 on keypad
The alarm emits a brief chirp after the first 4 digits but that's all.

An ominous voice from the alarm box says "4".

>type 1234 on alarm box
The keypad emits a sad chirp but nothing else happens.

>type 123
Nothing happens.

An ominous voice from the alarm box says "3".

>type 123
Nothing happens.

>type 12345
The alarm emits a brief chirp after the first 4 digits but that's all.

An ominous voice from the alarm box says "2".

>type 1789
The alarm goes silent and dark.

>l
Mud Room
This is an entrance hallway with a tiled floor. There is an alarm box on the wall next to the side door.

You can see a blue door here.

>type 1688
The keypad emits a sad chirp but nothing else happens.

>type 1688 on alarm box
The keypad emits a sad chirp but nothing else happens.

>actions
Actions listing on.

>type foo
[keypad-typing "foo"]
Nothing happens.

[keypad-typing "foo" - succeeded]

>type foo on alarm
[keypad-typing "foo"]
Nothing happens.

[keypad-typing "foo" - succeeded]

>x alarm
[examining the alarm box]
It's the control panel for a burglar alarm. It has a red LED labeled "ARMED" which is lit, and a green LED labeled "ALERT" which is dark. There is also a display which is currently blank.

[examining the alarm box - succeeded]

>take box
[taking the alarm box]
That's hardly portable.
[taking the alarm box - failed the can't take scenery rule]

>i
[taking inventory]
You are carrying:
  a brass key

[taking inventory - succeeded]

>l
[looking]
Mud Room
This is an entrance hallway with a tiled floor. There is an alarm box on the wall next to the side door.

You can see a blue door here.

[looking - succeeded]

* * *

>w
A tinny voice says "INTRUSION ALERT -- 5".
Mud Room
This is an entrance hallway with a tiled floor. There is an alarm box on the wall next to the side door. The side door leads out to the east.

This is a navy blue door that has been faded and peeled by a western exposure.

>type 18-99
I didn't understand that sentence.

>type 1999 on alarm
I didn't understand that sentence.

>type
I didn't understand that sentence.

>type 19-99 on keypad
I didn't understand that sentence.

* * *

>w
A tinny voice says "INTRUSION ALERT -- 5".
Mud Room
This is an entrance hallway with a tiled floor. There is an alarm box on the wall next to the side door. The side door leads out to the east.

This is a navy blue door that has been faded and peeled by a western exposure.

>type 7 on alarm
I didn't understand that sentence.

>type 8
I didn't understand that sentence.

>type 8 on door
I didn't understand that sentence.

>type
I didn't understand that sentence.

* * *

>w
A tinny voice says "INTRUSION ALERT -- 5".
Mud Room
This is an entrance hallway with a tiled floor. There is an alarm box on the wall next to the side door. The side door leads out to the east.

This is a navy blue door that has been faded and peeled by a western exposure.

>type 78
You may not name an object.

>type 7888
You may not name an object.

>type 78-88
You may not name an object.

>type 99-99
You may not name an object.

>type 99-99 on alarm
You may not name an object.

>actions
Actions listing on.

>type 1234
You may not name an object.

* * *

>w
A tinny voice says "INTRUSION ALERT -- 5".
Mud Room
This is an entrance hallway with a tiled floor. There is an alarm box on the wall next to the side door. The side door leads out to the east.

This is a navy blue door that has been faded and peeled by a western exposure.

>x alarm
The alarm box is beeping once a second. There is a display on the box that is showing a countdown. It currently reads 5.

>x alarm
The alarm box is beeping once a second. There is a display on the box that is showing a countdown. It currently reads 4.

>l
Mud Room
This is an entrance hallway with a tiled floor. There is an alarm box on the wall next to the side door.

You can see a blue door here.

>x alarm
The alarm box is beeping once a second. There is a display on the box that is showing a countdown. It currently reads 3.

>i
You are carrying:
  a brass key

>x alrm
You can't see any such thing.

>x alarm
The alarm box is beeping once a second. There is a display on the box that is showing a countdown. It currently reads 2.

>e
Side Porch
You're on the side porch. The house number is displayed in brass digits on the door.

You can see a blue door here.

>w
The alarm is ticking!

>i
You are carrying:
  a brass key

The alarm goes off with an earsplitting wail.

* * *

>x door
You see nothing special about the blue door.

>x number
It's a bit of rough slate, hanging from a nail, with a painting of an anchor and "1789" in big numbers.

>w
(first opening the blue door)
An ominous voice says "5".

>look
Mud Room
This is an entrance hallway with a tiled floor. There is an alarm box on the wall next to the side door.

This is a navy blue door that has been faded and peeled by a western exposure.

An ominous voice says "4".

>x alarm
It's the control panel for a burglar alarm. It has a red LED labeled "ARMED" which is lit, and a green LED labeled "ALERT" which is flashing. There is also a display which is currently 4.

>e
Side Porch
You're on the side porch. The number is painted on a slate panel next to the door.

This is a navy blue door that has been faded and peeled by a western exposure.

An ominous voice says "3".

>x
(the brass key)
You see nothing special about the brass key.

>x number
It's a bit of rough slate, hanging from a nail, with a painting of an anchor and "1789" in big numbers.

An ominous voice says "2".

>w
An ominous voice says "2".

>enter 1789
The alarm goes silent and dark.

>type 1789
You have re-armed the alarm system!

>e
Side Porch
You're on the side porch. The number is painted on a slate panel next to the door.

This is a navy blue door that has been faded and peeled by a western exposure.

>w
An ominous voice says "5".

>enter 1789
The alarm goes silent and dark.

>x alarm
It's the control panel for a burglar alarm. It has a red LED labeled "ARMED" which is not lit, and a green LED labeled "ALERT" which is dark. There is also a display which is currently blank.

>enter 1789
You have re-armed the alarm system!

>x alarm
It's the control panel for a burglar alarm. It has a red LED labeled "ARMED" which is lit, and a green LED labeled "ALERT" which is dark. There is also a display which is currently blank.

>quit
Are you sure you want to quit?

* * *

This door is alarmed!
An Interactive Fiction by Kent Quirk
Release 1 / Serial number 210305 / Inform 7 build 6M62 (I6/v6.34 lib 6/12N) SD

Side Porch
You're on the side porch. The number is painted on a slate panel next to the door. The door leads west.

This is a navy blue door that has been faded and peeled by a western exposure.

>x door
It's a blue door with a number next to it, heading in to the west.

>unlock door
(with the brass key)
You unlock the blue door.

>in
You can't go that way.

>open door
You open the blue door.

>w
An ominous voice says "5".