notepad
An Interactive Fiction by Kent Quirk
Release 1 / Serial number 220525 / Inform 7 build 6M62 (I6/v6.34 lib 6/12N) SD

office
You can see a desk (on which are a pencil and a stack of paper) here.

>get pencil
Taken.

>write foo in the notebook
You write "Note:  foo" into your notebook.

>write foo on the paper
You write "Note:  foo on the paper" into your notebook.

>read notebook
You read: 

Things I Wish I Didn't Have To Know

Note:  foo
Note:  foo on the paper

* * *

notepad
An Interactive Fiction by Kent Quirk
Release 1 / Serial number 220525 / Inform 7 build 6M62 (I6/v6.34 lib 6/12N) SD

office
You can see a desk (on which are a pencil and a stack of paper) here.

>n
hallway

>s
office
You can see a desk (on which are a pencil and a stack of paper) here.

>n
hallway

>get pencil
You can't see any such thing.

>yoink pencil
looking...

office...

hallway...

done.

You can't reach into the office.

>s
office
You can see a desk (on which are a pencil and a stack of paper) here.

>yoink pencil
looking...

office...

hallway...

done.

it's in deskYou yoink the pencil into your hands.

>i
You are carrying:
  a pencil
  your notebook

* * *

>n
hallway

>yoink pencil
That's not a verb I recognise.

>showme pencil
pencil - thing
location: on the desk in the office
singular-named, improper-named; unlit, inedible, portable
list grouping key: none
printed name: "pencil"
printed plural name: none
indefinite article: none
description: none
initial appearance: none

* * *

notepad
An Interactive Fiction by Kent Quirk
Release 1 / Serial number 220525 / Inform 7 build 6M62 (I6/v6.34 lib 6/12N) SD

office
You can see a desk (on which are a pencil and a stack of paper) here.

>take pencil
You write "Note:  whatever" into your notebook.

* * *

notepad
An Interactive Fiction by Kent Quirk
Release 1 / Serial number 220525 / Inform 7 build 6M62 (I6/v6.34 lib 6/12N) SD

office
You can see a desk (on which are a pencil and a stack of paper) here.

>write hello bob
You write "Note:  hello bob" into your notebook.

>read notebook
You read: 

Things I Wish I Didn't Have To Know

Note:  hello bob

>write it's ugly in here
You write "Note:  it's ugly in here" into your notebook.

>read notebook
You read: 

Things I Wish I Didn't Have To Know

Note:  hello bob
Note:  it's ugly in here

>drop notebook
Dropped.

>write does it work?
You will have to specify what to write that in.

>write does it work?
You will have to specify what to write that in.

>write does it work? in notebook
You write "Note:  does it work?" into your notebook.

>i
You are carrying nothing.

>read notebook
You read: 

Things I Wish I Didn't Have To Know

Note:  hello bob
Note:  it's ugly in here
Note:  does it work?

>remember the alamo
(you should probably write it down.)

>remember something
(you should probably write it down.)

>write down the alamo
You will have to specify what to write that in.

>get notebook
Taken.

>write down the deduction
You write "Note:  the deduction" into your notebook.

>erase
(your notebook)
You scrub out all the entries in your notebook.

>read notebook
There is nothing of note in your notebook.

>write 1 - something
You write "1: something" into your notebook.

>write 123 - something else
You write "123: something else" into your notebook.

>write hello there
You write "Note:  hello there" into your notebook.

>read notebook
You read: 

Things I Wish I Didn't Have To Know

1: something
123: something else
Note:  hello there