desksdrawers
An Interactive Fiction by Kent Quirk
Release 1 / Serial number 210316 / Inform 7 build 6M62 (I6/v6.34 lib 6/12N) SD

Study
You can see a desk and a file cabinet here.

>n
Kitchen
You can see a left cabinet and a right cabinet (on which is a mixer) here.

>open left
(the left cabinet)
You open the left cabinet, revealing the bucket.

>open right
(the right cabinet)
You open the right cabinet, revealing a severed head.

>take bucket
Taken.

>put head in bucket
(first taking the severed head)
You put the severed head into the bucket.

>x bucket
In the bucket is a severed head.

>i
You are carrying:
  the bucket
    a severed head

>close right
(the right cabinet)
You close the right cabinet.

>put bucket in left
(the left cabinet)
You place the bucket into the left cabinet.

>actions
Actions listing on.

>put bucket in left
(the left cabinet)
[inserting the bucket into the left cabinet]
[(1) inserting the bucket into the left cabinet's interior - silently]
(first taking the bucket)
[(2) taking the bucket - silently]
[(2) taking the bucket - silently - succeeded]

[(1) inserting the bucket into the left cabinet's interior - silently - succeeded]

You place the bucket into the left cabinet.
[inserting the bucket into the left cabinet - succeeded]

>rules
Rules tracing now switched on. Type "rules off" to switch it off again, or "rules all" to include even rules which do not apply.

* * *

>rulebooks
That's not a verb I recognise.

>help rules
That's not a verb I recognise.

>open cabinet door
Which do you mean, the left cabinet or the right cabinet?

>open left door
You can't see any such thing.

* * *

>n
Kitchen
You can see a left cabinet and a right cabinet (on which is a mixer) here.

>x left
(the left cabinet)
You see nothing special about the left cabinet.

>open left
(the left cabinet)
It isn't something you can open.

>open left door
You can't see any such thing.

>showme left
(the left cabinet)
left cabinet - kitchen-cabinet
    left cabinet's left drawer (part of left cabinet) - drawer
location: in the Kitchen
singular-named, improper-named; unlit, inedible, fixed in place; list grouping key: none
printed name: "left cabinet"
printed plural name: "kitchen-cabinets"
indefinite article: none
description: none
initial appearance: none
carrying capacity: 100

>open left drawer
Which do you mean, the left cabinet's left drawer or the right cabinet's left drawer?

>open left drawer of the left cabinet
Which do you mean, the left cabinet's left drawer or the right cabinet's left drawer?

>open left drawer of the right cabinet
Which do you mean, the left cabinet's left drawer or the right cabinet's left drawer?

>open the left cabinet's left drawer
Which do you mean, the left cabinet's left drawer or the right cabinet's left drawer?

* * *

>x left
(the left cabinet)
You see nothing special about the left cabinet.

>showme kitchen
Kitchen - room
    yourself - person
    left cabinet - kitchen-cabinet
        left cabinet's doorx (part of left cabinet) - cabinet-interior
    right cabinet - kitchen-cabinet
        right cabinet's doorx (part of right cabinet) - cabinet-interior
        mixer
singular-named, improper-named; lighted, visited
list grouping key: none
printed name: "Kitchen"
printed plural name: none
indefinite article: none
description: none

>x right
(the right cabinet)
On the right cabinet is a mixer.

>showme left
(the left cabinet)
left cabinet - kitchen-cabinet
    left cabinet's doorx (part of left cabinet) - cabinet-interior
location: in the Kitchen
singular-named, improper-named; unlit, inedible, fixed in place; list grouping key: none
printed name: "left cabinet"
printed plural name: "kitchen-cabinets"
indefinite article: none
description: none
initial appearance: none
carrying capacity: 100

>showme left interior
interior of the left cabinet - open container
    bucket
location: out of play
singular-named, improper-named; unlit, inedible, portable; opaque, open, unopenable, unlocked
list grouping key: none
printed name: "interior of the left cabinet"
printed plural name: "containers"
indefinite article: none
description: none
initial appearance: none
carrying capacity: 100

>open left
(the left cabinet)
It isn't something you can open.

>open left interio
You can't see any such thing.

>open left interior
You can't see any such thing.

>actions
Actions listing on.

>open left
(the left cabinet)
[opening the left cabinet]
It isn't something you can open.
[opening the left cabinet - failed the can't open unless openable rule]

>close the interior of the left cabinet
You can't see any such thing.

>showme the left cabinet's interior
I only understood you as far as wanting to showme the left cabinet's doorx.

>showme the interior of the left cabinet
interior of the left cabinet - open container
    bucket
location: out of play
singular-named, improper-named; unlit, inedible, portable; opaque, open, unopenable, unlocked
list grouping key: none
printed name: "interior of the left cabinet"
printed plural name: "containers"
indefinite article: none
description: none
initial appearance: none
carrying capacity: 100

>open left doorx
[opening the left cabinet's doorx]
You open the left cabinet's doorx.
[opening the left cabinet's doorx - succeeded]

* * *

desksdrawers
An Interactive Fiction by Kent Quirk
Release 1 / Serial number 210316 / Inform 7 build 6M62 (I6/v6.34 lib 6/12N) SD

Study
You can see a desk and a file cabinet here.

>open left
You open the desk's left drawer, revealing a pencil, a pen and a stapler.

>open top
You open the file cabinet's top drawer.

>open all drawers
You can't use multiple objects with that verb.

>loook
That's not a verb I recognise.

>look
Study
You can see a desk and a file cabinet here.

>x desk
It's a basic wooden desk with two drawers.

The desk's left drawer is open, and contains a pencil, a pen and a stapler.

>x
What do you want to examine?

>cabinet
You see nothing special about the file cabinet.

The file cabinet's top drawer is open.

>actions
Actions listing on.

>x cabinet
[examining the file cabinet]
You see nothing special about the file cabinet.

The file cabinet's top drawer is open.
[examining the file cabinet - succeeded]

>showme desk
desk - two-drawered-desk
    desk's left drawer (part of desk) - drawer
    desk's right drawer (part of desk) - drawer
        paper
        pencil
        pen
        stapler
location: in the Study
singular-named, improper-named; unlit, inedible, fixed in place; list grouping key: none
printed name: "desk"
printed plural name: "two-drawered-desks"
indefinite article: none
description: "It's a basic wooden desk with two drawers."
initial appearance: none
carrying capacity: 100

>showme desk's left drawer
desk's left drawer - drawer
    pencil
    pen
    stapler
location: part of the desk in the Study
singular-named, improper-named; unlit, inedible, portable; opaque, open, openable, unlocked
list grouping key: none
printed name: "desk's left drawer"
printed plural name: "drawers"
indefinite article: none
description: none
initial appearance: none
carrying capacity: 100

>x cabinet
[examining the file cabinet]
You see nothing special about the file cabinet.

The file cabinet's top drawer is open.
[examining the file cabinet - succeeded]

* * *

desksdrawers
An Interactive Fiction by Kent Quirk
Release 1 / Serial number 210316 / Inform 7 build 6M62 (I6/v6.34 lib 6/12N) SD

Study
You can see a desk and a file cabinet here.

>rules
Rules tracing now switched on. Type "rules off" to switch it off again, or "rules all" to include even rules which do not apply.

>open left
[Rule "declare everything initially unmentioned rule" applies.]
[Rule "announce items from multiple object lists rule" applies.]
[Rule "set pronouns from items from multiple object lists rule" applies.]
[Rule "before stage rule" applies.]
[Rule "instead stage rule" applies.]
[Rule "investigate player's awareness before action rule" applies.]
[Rule "player aware of his own actions rule" applies.]
[Rule "check stage rule" applies.]
[Rule "can't open unless openable rule" applies.]
[Rule "can't open what's locked rule" applies.]
[Rule "can't open what's already open rule" applies.]
[Rule "carry out stage rule" applies.]
[Rule "standard opening rule" applies.]
[Rule "after stage rule" applies.]
[Rule "investigate player's awareness after action rule" applies.]
[Rule "report stage rule" applies.]
[Rule "reveal any newly visible interior rule" applies.]
You open the desk's left drawer, revealing a pencil, a pen and a stapler.
[Rule "last specific action-processing rule" applies.]

[Rule "A first turn sequence rule" applies.]
[Rule "every turn stage rule" applies.]
[Rule "A last turn sequence rule" applies.]
[Rule "notify score changes rule" applies.]

* * *

>open left
(the left cabinet)
[Rule "declare everything initially unmentioned rule" applies.]
[Rule "announce items from multiple object lists rule" applies.]
[Rule "set pronouns from items from multiple object lists rule" applies.]
[Rule "before stage rule" applies.]
[Rule "instead stage rule" applies.]
[Rule "investigate player's awareness before action rule" applies.]
[Rule "player aware of his own actions rule" applies.]
[Rule "check stage rule" applies.]
[Rule "check opening a kitchen-cabinet ( called kc )" applies.]
[Rule "announce items from multiple object lists rule" applies.]
[Rule "set pronouns from items from multiple object lists rule" applies.]
[Rule "before stage rule" applies.]
[Rule "instead stage rule" applies.]
[Rule "investigate player's awareness before action rule" applies.]
[Rule "player aware of his own actions rule" applies.]
[Rule "check stage rule" applies.]
[Rule "can't open unless openable rule" applies.]
[Rule "can't open what's locked rule" applies.]
[Rule "can't open what's already open rule" applies.]
[Rule "carry out stage rule" applies.]
[Rule "standard opening rule" applies.]
[Rule "after stage rule" applies.]
[Rule "investigate player's awareness after action rule" applies.]
[Rule "report stage rule" applies.]
[Rule "reveal any newly visible interior rule" applies.]
You open the left cabinet's interior, revealing a bucket.
[Rule "last specific action-processing rule" applies.]

[Rule "A first turn sequence rule" applies.]
[Rule "every turn stage rule" applies.]
[Rule "A last turn sequence rule" applies.]
[Rule "notify score changes rule" applies.]

>open left
(the left cabinet)
[Rule "declare everything initially unmentioned rule" applies.]
[Rule "announce items from multiple object lists rule" applies.]
[Rule "set pronouns from items from multiple object lists rule" applies.]
[Rule "before stage rule" applies.]
[Rule "instead stage rule" applies.]
[Rule "investigate player's awareness before action rule" applies.]
[Rule "player aware of his own actions rule" applies.]
[Rule "check stage rule" applies.]
[Rule "check opening a kitchen-cabinet ( called kc )" applies.]
[Rule "announce items from multiple object lists rule" applies.]
[Rule "set pronouns from items from multiple object lists rule" applies.]
[Rule "before stage rule" applies.]
[Rule "instead stage rule" applies.]
[Rule "investigate player's awareness before action rule" applies.]
[Rule "player aware of his own actions rule" applies.]
[Rule "check stage rule" applies.]
[Rule "can't open unless openable rule" applies.]
[Rule "can't open what's locked rule" applies.]
[Rule "can't open what's already open rule" applies.]
That's already open.

[Rule "A first turn sequence rule" applies.]
[Rule "every turn stage rule" applies.]
[Rule "A last turn sequence rule" applies.]
[Rule "notify score changes rule" applies.]

* * *

desksdrawers
An Interactive Fiction by Kent Quirk
Release 1 / Serial number 210316 / Inform 7 build 6M62 (I6/v6.34 lib 6/12N) SD

Study
You can see a desk and a file cabinet here.

>x desk
You see nothing special about the desk.

>open left drawer
Which do you mean, the desk's left drawer or the chinese lacquer box's left drawer?

>open desk left drawer
I only understood you as far as wanting to open the desk.

>open desk's left drawer
You open the desk's left drawer, revealing a pencil.

>open box's left drawer
You open the chinese lacquer box's left drawer.

* * *

desksdrawers
An Interactive Fiction by Kent Quirk
Release 1 / Serial number 210316 / Inform 7 build 6M62 (I6/v6.34 lib 6/12N) SD

Study
You can see a desk and a file cabinet here.

>x left
You see nothing special about the desk's left drawer.

>n
Kitchen
You can see a left cabinet and a right cabinet (on which is a mixer) here.

* * *

>x left
(the left cabinet)
You see nothing special about the left cabinet.

>open left
(the left cabinet)
You open the left cabinet's bazz, revealing a bucket.

>open left frozbot
You can't see any such thing.

>actions
Actions listing on.

>rules
Rules tracing now switched on. Type "rules off" to switch it off again, or "rules all" to include even rules which do not apply.

>open right
(the right cabinet)
[Rule "declare everything initially unmentioned rule" applies.]
[opening the right cabinet]
[Rule "announce items from multiple object lists rule" applies.]
[Rule "set pronouns from items from multiple object lists rule" applies.]
[Rule "before stage rule" applies.]
[Rule "instead stage rule" applies.]
[Rule "investigate player's awareness before action rule" applies.]
[Rule "player aware of his own actions rule" applies.]
[Rule "check stage rule" applies.]
[Rule "check opening a kitchen-cabinet ( called kc )" applies.]
[opening the right cabinet - succeeded]

[Rule "A first turn sequence rule" applies.]
[Rule "every turn stage rule" applies.]
[Rule "A last turn sequence rule" applies.]
[Rule "notify score changes rule" applies.]

>foobar right cabinet to the right cabinet's frozbot
That's not a verb I recognise.

* * *

>open left
(the left cabinet)
You open the left cabinet's bazz, revealing a bucket.

>x left
(the left cabinet)
You see nothing special about the left cabinet.

The left cabinet's bazz is open, and contains a bucket.

>x riht
You can't see any such thing.

>x right
(the right cabinet)
On the right cabinet is a mixer.

>open right
(the right cabinet)
You open the right cabinet's bazz.

>x right
(the right cabinet)
On the right cabinet is a mixer.

The right cabinet's bazz is open.

>look in right
(the right cabinet)
On the right cabinet is a mixer.

>take bucket
Taken.

>take head
You can't see any such thing.

>showme left cabinet
left cabinet - kitchen-cabinet
    left cabinet's bazz (part of left cabinet) - ibazz
location: in the Kitchen
singular-named, improper-named; unlit, inedible, fixed in place; list grouping key: none
printed name: "left cabinet"
printed plural name: "kitchen-cabinets"
indefinite article: none
description: none
initial appearance: none
carrying capacity: 100

>showme left cabinet door
I only understood you as far as wanting to showme the left cabinet.

>showme left cabinet's door
I only understood you as far as wanting to showme the left cabinet's bazz.

>showme left cabinet's bazz
left cabinet's bazz - ibazz
location: part of the left cabinet in the Kitchen
singular-named, improper-named; unlit, inedible, portable; opaque, open, openable, unlocked
list grouping key: none
printed name: "left cabinet's bazz"
printed plural name: "ibazzs"
indefinite article: none
description: none
initial appearance: none
carrying capacity: 100

>x left cabinet's bazz
The left cabinet's bazz is empty.

* * *

>x left
You see nothing special about the desk's left drawer.

>open left
You open the desk's left drawer, revealing a pencil, a pen and a stapler.

>n
Kitchen
You can see a left cabinet and a right cabinet (on which is a mixer) here.

* * *

>x left
(the left cabinet)
You see nothing special about the left cabinet.

>open left
(the left cabinet)
You open the left cabinet's interior, revealing a bucket.

>open right
(the right cabinet)
You open the right cabinet's interior, revealing a severed head.

>x right
(the right cabinet)
On the right cabinet is a mixer.

The right cabinet is open, and contains a severed head.

>rules
Rules tracing now switched on. Type "rules off" to switch it off again, or "rules all" to include even rules which do not apply.

>close left
(the left cabinet)
[Rule "declare everything initially unmentioned rule" applies.]
[Rule "announce items from multiple object lists rule" applies.]
[Rule "set pronouns from items from multiple object lists rule" applies.]
[Rule "before stage rule" applies.]
[Rule "instead stage rule" applies.]
[Rule "investigate player's awareness before action rule" applies.]
[Rule "player aware of his own actions rule" applies.]
[Rule "check stage rule" applies.]
[Rule "can't close unless openable rule" applies.]
It isn't something you can close.

[Rule "A first turn sequence rule" applies.]
[Rule "every turn stage rule" applies.]
[Rule "A last turn sequence rule" applies.]
[Rule "notify score changes rule" applies.]