test
An Interactive Fiction by Kent Quirk
Release 1 / Serial number 210314 / Inform 7 build 6M62 (I6/v6.34 lib 6/12N) SD

sunporch
It's an open-air porch that is bordered by the ocean, only steps away. Apparently you can do that in this part of the world.

You see a small, generic, rectangular fishtank, containing what looks like salt water, with a sandy bottom and a plastic castle. Sitting on the castle is a hermit crab.

On the far wall is a low, metal file cabinet, painted black, with three drawers. The fishtank is on it.

You can also see a scallop shell, a conch shell and an empty wastebasket here.

>actions
Actions listing on.

>rules
Rules tracing now switched on. Type "rules off" to switch it off again, or "rules all" to include even rules which do not apply.

* * *

>examine file cabinet
On the black file cabinet is the fishtank (in which is a plastic castle (on which is a hermit crab)).

The black file cabinet has three drawers. None are open.

The hermit crab seems to be wanting something.

>x hermit crab
It's a small hermit crab wearing a tiny shell. It looks hungry. But maybe that's just the way crabs look.

>x drawers
You can't use multiple objects with that verb.

>x drawer
Which do you mean, the top, the middle or the bottom?

>x top drawer
You see nothing special about the top drawer.

>open top drawer
You open the top drawer of the black file cabinet, revealing an ancient candy bar, a jar of fishfood and a pencil.

>open middle drawer
You open the middle drawer of the black file cabinet, revealing a snail shell.

The hermit crab seems to stare at you accusingly.

>open bottom drawer
You open the bottom drawer of the black file cabinet, revealing some paper.

>take fishfood
Taken.

The hermit crab seems to be wanting something.

>i\
That's not a verb I recognise.

>i
You are carrying:
  a jar of fishfood (closed)

>feed crab
(the jar of fishfood)
The jar of fishfood isn't open.

The hermit crab seems to need attention.

>open fishfood
You open the jar of fishfood, revealing some fish flakes.

>feed crab
(the jar of fishfood)
(first taking the fish flakes)
As you shake the food on the water, the hermit crab seems to practically leap off its perch. The food quickly disappears and the crab clambers back to its castle.

[Your score has just gone up by one point.]

>look
Sunporch
It's an open-air porch that is bordered by the ocean, only steps away. Apparently you can do that here.

You see a small, generic, rectangular fishtank, containing what looks like salt water, with a sandy bottom and a plastic castle. Sitting on the castle is a hermit crab.

On the far wall is a low, metal file cabinet, painted black, with three drawers. The fishtank is on it.

You can also see a scallop shell, a conch shell and an empty wastebasket here.

The hermit crab barely fits into its shell.

>x scallop shell
It's a good-sized decorative white scallop shell. It's pretty.

>x conch shell
It's a large spiral conch shell. You put it to your ear for a moment and "hear the ocean".

The hermit crab still seems uncomfortable in that tiny shell.

>open bottom drawer
That's already open.

>take candy bar
Taken.

>take pencil
Taken.

>x candy bar
You see nothing special about the ancient candy bar.

The hermit crab seems to need a new shell.

>x pencil
You see nothing special about the pencil.

>x snail shell
It's a medium-sized spiral snail shell.

>look
Sunporch
It's an open-air porch that is bordered by the ocean, only steps away. Apparently you can do that here.

You see a small, generic, rectangular fishtank, containing what looks like salt water, with a sandy bottom and a plastic castle. Sitting on the castle is a hermit crab.

On the far wall is a low, metal file cabinet, painted black, with three drawers. The fishtank is on it.

You can also see a scallop shell, a conch shell and an empty wastebasket here.

>x hermit crab
It's a small hermit crab wearing a tiny shell. It looks awkward. But maybe that's just the way crabs look.

The hermit crab seems to need a new shell.

>x castle
To no one's surprise -- not even the hermit crab's -- it's a cheap plastic castle just like everyone buys for their first fish tank.

On the plastic castle is a hermit crab.

The hermit crab seems to need a new shell.

>x water
You can't see any such thing.

>look
Sunporch
It's an open-air porch that is bordered by the ocean, only steps away. Apparently you can do that here.

You see a small, generic, rectangular fishtank, containing what looks like salt water, with a sandy bottom and a plastic castle. Sitting on the castle is a hermit crab.

On the far wall is a low, metal file cabinet, painted black, with three drawers. The fishtank is on it.

You can also see a scallop shell, a conch shell and an empty wastebasket here.

>give crab shell
Which do you mean, the snail shell, the scallop shell or the conch shell?

>give crab conch shell
(first taking the conch shell)
Immediately, the hermit crab crawls over to inspect the conch shell.  It leaves its own shell behind and scrambles in. After a long pause, it scuttles back into its original shell. You could swear you saw it shake its tiny head.
 Then it crawls back to its place on the plastic castle.

The hermit crab seems to need a new shell.

>take conch shell
Taken.

The hermit crab seems to need a new shell.

>give crab snail shell
(first taking the snail shell)
Once you drop it in, the hermit crab scrambles over to inspect the snail shell.  It pauses, then rushes into the new shell, disappearing inside. After a moment, it pops its head out. It already seems happier.
 Then it crawls back to its home on the plastic castle.

[Your score has just gone up by two points.]

>look
Sunporch
It's an open-air porch that is bordered by the ocean, only steps away. Apparently you can do that here.

You see a small, generic, rectangular fishtank, containing what looks like salt water, with a sandy bottom and a plastic castle. Sitting on the castle is a hermit crab.

On the far wall is a low, metal file cabinet, painted black, with three drawers. The fishtank is on it.

You can also see a scallop shell and an empty wastebasket here.

>take hermit crab
I don't suppose the hermit crab would care for that.

The hermit crab seems to be dreaming of the open sea.

>take fishtank
It's got so much salt water in it that you will surely spill it. Maybe you should take some of the salt water out.

The hermit crab appears to be gazing longingly toward the ocean.

>look
Sunporch
It's an open-air porch that is bordered by the ocean, only steps away. Apparently you can do that here.

You see a small, generic, rectangular fishtank, containing what looks like salt water, with a sandy bottom and a plastic castle. Sitting on the castle is a hermit crab.

On the far wall is a low, metal file cabinet, painted black, with three drawers. The fishtank is on it.

You can also see a scallop shell and an empty wastebasket here.

The hermit crab seems to be dreaming of the open sea.

>put crab in wastebasket
(first taking the hermit crab)
I don't suppose the hermit crab would care for that.

>i
You are carrying:
  a conch shell
  a pencil
  an ancient candy bar
  a jar of fishfood (open but empty)

>put crab in scallop shell
(first taking the hermit crab)
I don't suppose the hermit crab would care for that.

>take water from tank
You can't see any such thing.

>look
Sunporch
It's an open-air porch that is bordered by the ocean, only steps away. Apparently you can do that here.

You see a small, generic, rectangular fishtank, containing what looks like salt water, with a sandy bottom and a plastic castle. Sitting on the castle is a hermit crab.

On the far wall is a low, metal file cabinet, painted black, with three drawers. The fishtank is on it.

You can also see a scallop shell and an empty wastebasket here.

>empty tank
(in the empty wastebasket)
(first taking the wastebasket)
You fill the wastebasket with salt water from the fishtank.

>take tank
It's going to slosh if try you move it like this. 
The hermit crab appears to be gazing longingly toward the ocean.

>x tank
The fishtank is about half full of salt water.

In the fishtank are a tiny shell, a snail shell and a plastic castle.

>empty tank
(in the wastebasket of salt water)
The wastebasket cannot contain any more than it already holds.

The hermit crab seems to be pining for the great outdoors.

>empty waste basket
You can't see any such thing.

>empty wastebasket
(in the wastebasket of salt water)
You can hardly pour the wastebasket into itself.

>take wastebasket
You already have that.

>empty wastebasket outside
I didn't understand that sentence.

>empty wastebasket into ocean
You dump out the wastebasket into the ocean.

>empty tank
(in the empty wastebasket)
You fill the wastebasket with salt water from the fishtank.

>x tank
The fishtank is less than half full of salt water.

In the fishtank are a tiny shell, a snail shell and a plastic castle.

>take tank
It's going to be awkward to carry with the plastic castle in it.

The hermit crab seems to be dreaming of the open sea.

>take castle
The hermit crab politely chitters out of the way to the floor of the aquarium.

Taken.

The hermit crab seems to be pining for the great outdoors.

>take tank
Taken.

>take tank to ocean
I only understood you as far as wanting to take the fishtank of salt water.

>take tank to beach
I only understood you as far as wanting to take the fishtank of salt water.

>empty tank into ocean
You carefully dump salt water out of the fishtank. The hermit crab seizes its opportunity and leaps into the ocean. You catch a glimpse of it happily crawling across the bottom before it goes out of sight.

    *** Congratulations! You have freed the tiny hermit crab. ***

In that game you scored 6 out of a possible 6, in 48 turns.

Would you like to RESTART, RESTORE a saved game, QUIT or UNDO the last command?

* * *

>fill can from tank
(first taking the wastebasket)
You fill the wastebasket with salt water from the fishtank.

The crab stares at you accusingly.

>pour can in ocean
You dump out the wastebasket into the ocean.

The crab stares at you accusingly.

>take tank
It's got so much salt water in it that you will surely spill it.

The crab stares at you accusingly.

>fill can from tank
You fill the wastebasket with salt water from the fishtank.

The crab stares at you accusingly.

>take tank
Taken.

The crab stares at you accusingly.

>drop tank
Dropped.

The crab stares at you accusingly.

>fill can from tank
The wastebasket cannot contain any more than it already holds.

The crab stares at you accusingly.

>pour can in ocean
You dump out the wastebasket into the ocean.

The crab stares at you accusingly.

>x tank
The fishtank is less than half full of salt water.

In the fishtank is a plastic castle.

The crab stares at you accusingly.

>fill can from tank
You fill the wastebasket with salt water from the fishtank.

The crab stares at you accusingly.

>x tank
The fishtank is mostly empty of salt water.

In the fishtank is a plastic castle.

The crab stares at you accusingly.

* * *

>fill can with tank
(first taking the wastebasket)
You fill the wastebasket with salt water from the fishtank.

The hermit crab seems to be wanting something.

>dump can in ocean
You dump out the wastebasket into the ocean.

The hermit crab seems to need attention.

>pour can in ocean
The wastebasket already contains nothing.

>fill can from tank
You fill the wastebasket with salt water from the fishtank.

The hermit crab seems to stare at you accusingly.

>dump can in ocean
You dump out the wastebasket into the ocean.

The hermit crab seems to need attention.

>x tank
The fishtank is less than half full of salt water.

In the fishtank is a plastic castle.

>take tank
It's going to be awkward to carry with the plastic castle in it.

The hermit crab seems to stare at you accusingly.

>take castle
The hermit crab lifts its tiny gripping claw in a wordless challenge, and you back off. Perhaps it needs something from you.

The hermit crab seems to be wanting something.

>x crab
It's a small hermit crab in a tiny shell. It looks annoyed. But maybe that's just a crab thing.

The hermit crab seems to stare at you accusingly.

>x
(the empty wastebasket)
It's a small plastic trash can.

The empty wastebasket contains only a trace of salt water at the bottom.

The hermit crab seems hungry.

>open top drawer
You open the upper drawer of the file cabinet, revealing some paper.

The hermit crab seems to be wanting something.

>open bottom drawer
You open the lower drawer of the file cabinet, revealing an ancient candy bar, some crab food and a pencil.

>take crab food
Taken.

The hermit crab seems to stare at you accusingly.

>feed crab
What do you want to feed the hermit crab?

>food
I only understood you as far as wanting to feed the hermit crab the hermit crab.

>feed hermit crab
What do you want to feed the hermit crab?

>food
As you shake the food on the water, the hermit crab seems to practically leap off its perch. The food quickly disappears.

* * *

>fill wastebasket from fishtank
(first taking the wastebasket)
You fill the wastebasket with salt water from the fishtank.

>take fishtank
Taken.

>i
You are carrying:
  the fishtank of salt water
  the wastebasket of salt water

>drop fishtank
Dropped.

>x fishtank
The fishtank is about half full of salt water.

In the fishtank is a crab.

>x fishtank
The fishtank is about half full of salt water.

In the fishtank is a crab.

>x crab
You see nothing special about the crab.

>put book in fishtank
The book doesn't go into liquids.

>get crab
Taken.

>put crab in fishtank
You put the crab into the fishtank of salt water.

>showme crab
That's not a verb I recognise.

* * *

>fill wastebasket from fishtank
(first taking the wastebasket)
You fill the wastebasket with salt water from the fishtank.

>x wastebasket
The wastebasket is full of salt water.

>drop fishtank
The fishtank of salt water is already here.

* * *

>fill wastebasket from tank
(first taking the wastebasket)
You fill the wastebasket with salt water from the fishtank.

The crab stares at you accusingly.

* * *

>give conch to crab
(first taking the conch shell)
As soon as you get your hand out of the aquarium, the hermit crab climbs over to inspect the conch shell.  It leaves its own shell behind and clambers in. After a long pause, it scrambles back into its original shell. You could swear you saw it shake its tiny head.
 Then it climbs back to its place on the plastic castle.

>give snail to crab
(first taking the snail shell)
Soon, the hermit crab clambers over to inspect the snail shell.  It pauses, then rushes into the new shell, disappearing inside. After a moment, it pops its head out.
 Then it chitters back to its home on the plastic castle.

The hermit crab seems to need attention.

>give food to crab
You can't see any such thing.

>open drawer
Which do you mean, the upper or the lower?

>lower
You open the lower drawer of the file cabinet, revealing some paper.

The hermit crab seems to be wanting something.

>give candy to crab
You can't see any such thing.

>open drawer
(the upper drawer of the file cabinet)
You open the upper drawer of the file cabinet, revealing an ancient candy bar, some crab food and a pencil.

The hermit crab seems hungry.

>get crab food
Taken.

>give food to crab
(the hermit crab)
As you shake the food on the water, the hermit crab seems to practically leap off its perch. The food quickly disappears.

>look
Den
It's a den that happens to open onto the ocean.

It is a small, generic, rectangular fishtank, containing what looks like salt water, with a sandy bottom and a plastic castle. Sitting on the castle is a hermit crab.

On the far wall is a low, metal file cabinet, painted black, with two drawers. There's a fishtank on it.

You can also see a scallop shell, an empty wastebasket and a book here.

>x crab
It's a small hermit crab in a tiny shell. It looks annoyed. But maybe that's just a crab thing.

The hermit crab seems wistful.

>x castle
To no one's surprise -- not even the hermit crab's -- it's a cheap plastic castle just like everyone buys for their first fish tank.

On the plastic castle is a hermit crab.

The hermit crab appears to be gazing longingly south.

>take castle
The hermit crab politely crawls to the floor of the aquarium.

Taken.

>x tank
The fishtank is more than half full of salt water.

In the fishtank are a hermit crab, a tiny shell and a conch shell.

The hermit crab seems wistful.

>take tank
It's got so much salt water in it that you will surely spill it.

The hermit crab looks lonely.

>fill wastebasket from tank
(first taking the wastebasket)
You fill the wastebasket with salt water from the fishtank.

The hermit crab seems wistful.

>pour can into ocean
You dump out the wastebasket into the ocean.

>fill can from tank
You fill the wastebasket with salt water from the fishtank.

The hermit crab appears to be gazing longingly south.

>take tank
It's going to be awkward to carry with the tiny shell in it.

>take tiny shell
Taken.

>take tank
It's going to be awkward to carry with the conch shell in it.

>take conch
Taken.

>take tank
It's going to be awkward to carry with the snail shell in it.

The hermit crab looks lonely.

>take snail
That seems to belong to the hermit crab.

The hermit crab appears to be gazing longingly south.

>take tank
It's going to be awkward to carry with the snail shell in it.

The hermit crab seems wistful.

* * *

>give scallop to the crab
(first taking the scallop shell)
You put the scallop shell into the fishtank of salt water.

>actions
Actions listing on.

>give scallop to the crab
[giving the scallop shell to the hermit crab]
(first taking the scallop shell)
[(1) taking the scallop shell - silently]
[(1) taking the scallop shell - silently - succeeded]

[(1) inserting the scallop shell into the fishtank of salt water]
You put the scallop shell into the fishtank of salt water.
[(1) inserting the scallop shell into the fishtank of salt water - succeeded]

[giving the scallop shell to the hermit crab - succeeded]

>rules
Rules tracing now switched on. Type "rules off" to switch it off again, or "rules all" to include even rules which do not apply.

* * *

>l
Den
It's a den that happens to open onto the ocean.

The crab stares at you accusingly.

>x den
You can't see any such thing.

>look
Den
It's a den that happens to open onto the ocean.

The crab stares at you accusingly.

>rules
Rules tracing now switched on. Type "rules off" to switch it off again, or "rules all" to include even rules which do not apply.

[Rule "Before reading a command" applies.]

>look
[Rule "declare everything initially unmentioned rule" applies.]
[Rule "determine visibility ceiling rule" applies.]
[Rule "announce items from multiple object lists rule" applies.]
[Rule "set pronouns from items from multiple object lists rule" applies.]
[Rule "before stage rule" applies.]
[Rule "instead stage rule" applies.]
[Rule "investigate player's awareness before action rule" applies.]
[Rule "player aware of his own actions rule" applies.]
[Rule "check stage rule" applies.]
[Rule "carry out stage rule" applies.]
[Rule "declare everything unmentioned rule" applies.]
[Rule "room description heading rule" applies.]
Den
[Rule "room description body text rule" applies.]
It's a den that happens to open onto the ocean.

[Rule "new object description rule" applies.]
[Rule "marking rule" applies.]
[Rule "swift rule" applies.]
[Rule "swift rule" applies.]
[Rule "swift rule" applies.]
[Rule "swift rule" applies.]
[Rule "swift rule" applies.]
[Rule "swift rule" applies.]
[Rule "swift rule" applies.]
[Rule "swift rule" applies.]
[Rule "swift rule" applies.]
[Rule "swift rule" applies.]
[Rule "mentioning tedious things rule" applies.]
[Rule "determining concealment rule" applies.]
[Rule "concealing parts rule" applies.]
[Rule "ordinary-concealment rule" applies.]
[Rule "don't mention things out of play rule" applies.]
[Rule "loading table rule" applies.]
[Rule "description-ranking rule" applies.]
[Rule "reporting descriptions rule" applies.]
[Rule "table-debugging rule" applies.]
[Rule "check new arrival rule" applies.]
[Rule "after stage rule" applies.]
[Rule "investigate player's awareness after action rule" applies.]
[Rule "report stage rule" applies.]
[Rule "other people looking rule" applies.]
[Rule "last specific action-processing rule" applies.]
[Rule "A first turn sequence rule" applies.]
[Rule "every turn stage rule" applies.]
[Rule "Every turn while the crab is visible" applies.]
The crab stares at you accusingly.

[Rule "A last turn sequence rule" applies.]
[Rule "notify score changes rule" applies.]
[Rule "Before reading a command" applies.]

* * *

>loo
That's not a verb I recognise.

>l
Den
It's a den that happens to open onto the ocean.

The crab stares at you accusingly.

>look at tank
The fishtank is about half full of salt water.

In the fishtank is a painted ceramic castle.

The crab stares at you accusingly.

* * *

>look
Den
It's a den that happens to open onto the ocean.

It is a small, generic, rectangular fishtank.

On the far wall is a low, metal file cabinet, painted black, with two drawers. There's a fishtank on it.

You can also see the empty wastebasket and a book here.

The crab stares at you accusingly.

>paragraphs
That's not a verb I recognise.

>look
Den
It's a den that happens to open onto the ocean.

It is a small, generic, rectangular fishtank.

On the far wall is a low, metal file cabinet, painted black, with two drawers. There's a fishtank on it.

You can also see the empty wastebasket and a book here.

The crab stares at you accusingly.

>rules
Rules tracing now switched on. Type "rules off" to switch it off again, or "rules all" to include even rules which do not apply.

* * *

>look
Den
It's a den that happens to open onto the ocean.

It is a small, generic, rectangular fishtank.

On the far wall is a low, metal file cabinet, painted black, with two drawers. There's a fishtank on it.

You can also see the empty wastebasket and a book here.

The crab stares at you accusingly.

>pour fishtank into ocean
You dump out the fishtank into the ocean.

>fill wastebasket from ocean
(first taking the wastebasket)
You fill the wastebasket up with salt water from the ocean.

>actions
Actions listing on.

>pour wastebasket into fishtank
[pouring the wastebasket into the fishtank]
You pour salt water into the fishtank, leaving the wastebasket empty. It is about half full of salt water.

[pouring the wastebasket into the fishtank - succeeded]

>fill wastebasket from fishtank
[filling the empty wastebasket with the fishtank of salt water]
[(1) pouring the fishtank into the wastebasket]
You pour salt water into the wastebasket, leaving the fishtank empty.
[(1) pouring the fishtank into the wastebasket - succeeded]

[filling the wastebasket of salt water with the empty fishtank - succeeded]

* * *

>look
Den
It's a den that happens to open onto the ocean.

It is a small, generic, rectangular fishtank.

On the far wall is a low, metal file cabinet, painted black, with two drawers. There's a fishtank on it.

You can also see the empty wastebasket and a book here.

The crab stares at you accusingly.

>showme
Den - room
    yourself - person
    file cabinet - supporter
        upper drawer (part of file cabinet) - drawer
        lower drawer (part of file cabinet) - drawer
            *pencil
            *paper
        fishtank of salt water - fluid container
            painted ceramic castle - supporter
                hermit crab - animal
    empty wastebasket - fluid container
    ocean - liquid lake
    book
* denotes things which are not in scope

>showme file cabinet
file cabinet - supporter
    upper drawer (part of file cabinet) - drawer
    lower drawer (part of file cabinet) - drawer
        pencil
        paper
    fishtank of salt water - fluid container
        painted ceramic castle - supporter
            hermit crab - animal
location: in Den
singular-named, improper-named, unmarked for special listing; unlit, inedible, fixed in place, unsubmersible; list grouping key: none
printed name: "file cabinet"
printed plural name: "supporters"
indefinite article: none
description: none
initial appearance: "It's a low, metal file cabinet, painted black, with two drawers."
description-rank: 5
carrying capacity: 100

* * *

>look
Den
It's a den that happens to open onto the ocean.

It is a small, generic, rectangular fishtank.

On the far wall is a low, metal file cabinet, painted black, with two drawers. There's a fishtank on it.

You can also see the empty wastebasket and a book here.

The crab stares at you accusingly.

>x fishtank
The fishtank is about half full of salt water.

In the fishtank is a painted ceramic castle.

The crab stares at you accusingly.

>x castle
It's a cheap kind of castle everyone buys for their first fish tank.

On the painted ceramic castle is a hermit crab.

The crab stares at you accusingly.

>x
What do you want to examine?

>crab
You see nothing special about the hermit crab.

The crab stares at you accusingly.

>lok
That's not a verb I recognise.

>l
Den
It's a den that happens to open onto the ocean.

The crab stares at you accusingly.

* * *

>open drawer
Which do you mean, the top, the middle or the bottom?

>open top
You open the top drawer of the black file cabinet.

The hermit crab seems to be wanting something.

>get snail
You can't see any such thing.

>open middle
You open the middle drawer of the black file cabinet, revealing a snail shell and some paper.

>open bottom
You open the bottom drawer of the black file cabinet, revealing an ancient candy bar, a jar of fishfood and a pencil.

The hermit crab seems to stare at you accusingly.

>get jar
Taken.

>open jar
You open the jar of fishfood, revealing some fish flakes.

>pour jar
(in the empty wastebasket)
You can't pour the jar of fishfood.

The hermit crab seems to be wanting something.

>feed fish
(to the hermit crab)
(first taking the fish flakes)
As you shake the food on the water, the hermit crab seems to practically leap off its perch. The food quickly disappears and the crab chitters back to its castle.

[Your score has just gone up by one point.]

>look
Sunporch
It's an open-air porch that is bordered by the ocean, only steps away. Apparently you can do that here.

You see a small, generic, rectangular fishtank, containing what looks like salt water, with a sandy bottom and a plastic castle. Sitting on the castle is a hermit crab.

On the far wall is a low, metal file cabinet, painted black, with three drawers. The fishtank is on it.

You can also see an empty wastebasket here.

The hermit crab barely fits into its shell.

>x crab
It's a small hermit crab wearing a tiny shell. It looks awkward. But maybe that's just the way crabs look.

The hermit crab still seems uncomfortable in that tiny shell.

>x shell
A medium-sized spiral shell from a snail.

>x tiny
You can't see any such thing.

>take crab
I don't suppose the hermit crab would care for that.

The hermit crab seems to need a new shell.

>showme crab
hermit crab - animal
location: on the plastic castle in the fishtank of salt water on the black file cabinet in the Sunporch
singular-named, improper-named, unmarked for special listing; unlit, inedible, portable, submersible; male, neuter; well-fed, cramped, captive, chatty
list grouping key: none
printed name: "hermit crab"
printed plural name: "animals"
indefinite article: none
description: "It's a small hermit crab wearing a tiny shell. It looks awkward. But maybe that's just the way crabs look."
initial appearance: none
carrying capacity: 100
houseshell: tiny shell

>x crab
It's a small hermit crab wearing a tiny shell. It looks awkward. But maybe that's just the way crabs look.

>take castle
The hermit crab lifts its tiny gripping claw in a wordless challenge, and you back off. Perhaps it needs something from you.

The hermit crab seems to need a new shell.

I beg your pardon?

I beg your pardon?

>give snail to crab
(first taking the snail shell)
As soon as you get your hand out of the aquarium, the hermit crab scrambles over to inspect the snail shell.  It pauses, then rushes into the new shell, disappearing inside. After a moment, it pops its head out. It already seems happier.
 Then it clambers back to its place on the plastic castle.

[Your score has just gone up by two points.]

>i
You are carrying:
  a jar of fishfood (open but empty)

The hermit crab seems to be pining for the great outdoors.

>drop jar
Dropped.

>get crab
I don't suppose the hermit crab would care for that.

>release
That's not a verb I recognise.

>release crab
That's not a verb I recognise.

>take castle
The hermit crab politely crawls out of the way to the floor of the aquarium.

Taken.

The hermit crab seems to be dreaming of the open sea.

>take aquarium
It's too full to move safely. Maybe you should take some of the salt water out.

The hermit crab appears to be gazing longingly toward the ocean.

>pour aquarium into wastebasket
(first taking the wastebasket)
You fill the wastebasket with salt water from the fishtank.

>pour wastebasket into ocean
You dump out the wastebasket into the ocean.

>look
Sunporch
It's an open-air porch that is bordered by the ocean, only steps away. Apparently you can do that here.

You see a small, generic, rectangular fishtank, containing what looks like salt water, with a sandy bottom and a plastic castle. Sitting on the castle is a hermit crab.

On the far wall is a low, metal file cabinet, painted black, with three drawers. The fishtank is on it.

You can also see a jar of fishfood (empty) here.

>x crab
It's a small hermit crab wearing a snail shell. It looks wistful. But maybe that's just the way crabs look.

>look at tank
The fishtank is about half full of salt water.

In the fishtank are a hermit crab, a tiny shell and a snail shell.

>empty tank
(in the empty wastebasket)
You fill the wastebasket with salt water from the fishtank.

The hermit crab seems to be pining for the great outdoors.

>look at tank
The fishtank is less than half full of salt water.

In the fishtank are a hermit crab, a tiny shell and a snail shell.

The hermit crab seems to be dreaming of the open sea.

>look
Sunporch
It's an open-air porch that is bordered by the ocean, only steps away. Apparently you can do that here.

You see a small, generic, rectangular fishtank, containing what looks like salt water, with a sandy bottom and a plastic castle. Sitting on the castle is a hermit crab.

On the far wall is a low, metal file cabinet, painted black, with three drawers. The fishtank is on it.

You can also see a jar of fishfood (empty) here.

The hermit crab seems to be pining for the great outdoors.

>get tank
Taken.

The hermit crab seems to be dreaming of the open sea.

>pour tank into ocean
You carefully dump salt water out of the fishtank. The hermit crab seizes its opportunity and leaps into the ocean. You catch a glimpse of it happily crawling across the bottom before it goes out of sight.

    *** Congratulations! You have freed the grateful hermit crab. ***

In that game you scored 6 out of a possible 6, in 29 turns.

Would you like to RESTART, RESTORE a saved game, QUIT or UNDO the last command?

* * *

>open drawer
Which do you mean, the top, the middle or the bottom?

>open upper
You open the upper drawer of the file cabinet, revealing a jar of fishfood.

>open lower
You open the lower drawer of the file cabinet, revealing an ancient candy bar, some paper and a pencil.

The hermit crab seems to need attention.

>get jar
Taken.

The hermit crab seems to be wanting something.

>feed food to fish
You can't see any such thing.

>open jar
You open the jar of fishfood, revealing some fish flakes.

>close jar
You close the jar of fishfood.

>feed jar to fish
You can't see any such thing.

>feed jar to crab
The jar of fishfood isn't open.

>open jar
You open the jar of fishfood, revealing some fish flakes.

The hermit crab seems to need attention.

>feed jar to crab
(first taking the fish flakes)
As you shake the food on the water, the hermit crab seems to practically leap off its perch. The food quickly disappears.

>x crab
It's a small hermit crab with a tiny shell. It looks annoyed. But maybe that's just a crab thing.

The hermit crab still seems uncomfortable.

>g
It's a small hermit crab with a tiny shell. It looks annoyed. But maybe that's just a crab thing.

The hermit crab is hanging awkwardly onto its shell.

>g
It's a small hermit crab with a tiny shell. It looks annoyed. But maybe that's just a crab thing.

>g
It's a small hermit crab with a tiny shell. It looks annoyed. But maybe that's just a crab thing.

The hermit crab unsuccessfully tries to squirm deeper into its shell.

>g
It's a small hermit crab with a tiny shell. It looks annoyed. But maybe that's just a crab thing.

>g
It's a small hermit crab with a tiny shell. It looks annoyed. But maybe that's just a crab thing.

The hermit crab still seems uncomfortable.

>g
It's a small hermit crab with a tiny shell. It looks annoyed. But maybe that's just a crab thing.

>g
It's a small hermit crab with a tiny shell. It looks annoyed. But maybe that's just a crab thing.

* * *

>g
It's a small hermit crab with a tiny shell. It looks annoyed. But maybe that's just a crab thing.

The hermit crab still seems uncomfortable.

>g
It's a small hermit crab with a tiny shell. It looks annoyed. But maybe that's just a crab thing.

The hermit crab is hanging awkwardly onto its shell.

>put shell in tank
Which do you mean, the scallop shell, the conch shell or the snail shell?

>give snail shell to crab
(first taking the snail shell)
Once you drop it in, the hermit crab chitters over to inspect the snail shell.  It pauses, then rushes into the new shell, disappearing inside. After a moment, it pops its head out. It already seems happier.
 Then it climbs back to its place on the plastic castle.

The hermit crab seems wistful.

>x crab
It's a small hermit crab with a snail shell. It looks annoyed. But maybe that's just a crab thing.

The hermit crab appears to be gazing longingly south.

* * *

>open top
You open the top drawer of the black file cabinet, revealing an ancient candy bar and a jar of fishfood.

The hermit crab seems to stare at you accusingly.

>eat candy
(first taking the ancient candy bar)
You eat the ancient candy bar. Not bad.

The hermit crab seems to need attention.

>open middl
You can't see any such thing.

>open middle
You open the middle drawer of the black file cabinet, revealing a pencil.

>get fishfood
Taken.

>open fishfood
You open the jar of fishfood, revealing some fish flakes.

>feed crab
(the jar of fishfood)
(first taking the fish flakes)
As you shake the food on the water, the hermit crab seems to practically leap off its perch. The food quickly disappears and the crab scrambles back to its castle.

[Your score has just gone up by one point.]

>open bottom
You open the bottom drawer of the black file cabinet, revealing a snail shell and some paper.

The hermit crab looks like it barely fits into its shell.

>get fishfood
You already have that.

>feed crab
(the jar of fishfood)
Those aren't available.

The hermit crab still seems uncomfortable in that tiny shell.

>open fishfood
That's already open.

The hermit crab seems to need a new shell.

>feed crab
(the jar of fishfood)
Those aren't available.

The hermit crab seems to need a new shell.

>get snail
Taken.

The hermit crab seems to need a new shell.

>give snail to crab
You place the snail shell into the aquarium. As soon as you get your hand out, the hermit crab climbs over to inspect the snail shell.  It pauses, then rushes into the new shell, disappearing inside. After a moment, it pops its head out. It already seems happier.
 Then it crawls back to its home on the plastic castle.

[Your score has just gone up by two points.]

>x tank
The fishtank is more than half full of salt water.

In the fishtank are a tiny shell, a snail shell and a plastic castle.

>get tiny
Taken.

The hermit crab seems to be pining for the great outdoors.

>fill can
(first taking the wastebasket)
You fill the wastebasket up with salt water from the ocean.

>pour can into ocean
You dump out the wastebasket into the ocean.

>fill can
You fill the wastebasket with salt water from the fishtank.

The hermit crab appears to be gazing longingly toward the ocean.

>x tank
The fishtank is about half full of salt water.

In the fishtank are a snail shell and a plastic castle.

The hermit crab seems to be dreaming of the open sea.

>pour can
(in the wastebasket of salt water)
You can hardly pour the wastebasket into itself.

>pour can into ocean
You dump out the wastebasket into the ocean.

The hermit crab appears to be gazing longingly toward the ocean.

>x tank
The fishtank is about half full of salt water.

In the fishtank are a snail shell and a plastic castle.

>showme tank
fishtank of salt water - fluid container
    snail shell - shell
    plastic castle - supporter
        hermit crab - animal
location: on the black file cabinet in the sunporch
singular-named, improper-named, unmarked for special listing; unlit, inedible, portable, unsubmersible; opaque, open, unopenable, unlocked; list grouping key: none
printed name: "fishtank"
printed plural name: "fluid containers"
indefinite article: "the"
description: none
initial appearance: "You see a small, generic, rectangular fishtank, containing what looks like salt water, with a sandy bottom and a plastic castle. Sitting on the castle is a hermit crab."
carrying capacity: 100
fluid capacity: 10 gallons
fluid content: 5 gallons
liquid: salt water

>fill can from tank
You fill the wastebasket with salt water from the fishtank.

>x tank
The fishtank is less than half full of salt water.

In the fishtank are a snail shell and a plastic castle.

The hermit crab seems to be dreaming of the open sea.

>drop can
Dropped.

The hermit crab seems to be pining for the great outdoors.

>get tank
It's going to be awkward to carry with the plastic castle in it.

>get castle
The hermit crab politely chitters out of your way, onto the floor of the aquarium.

Taken.

The hermit crab appears to be gazing longingly toward the ocean.

>get tank
Taken.

>pour tank into ocean
You carefully dump salt water out of the fishtank. The hermit crab seizes its opportunity and leaps into the ocean. You catch a glimpse of it happily crawling across the bottom before it goes out of sight.

    *** Congratulations! You have freed the grateful hermit crab. ***

In that game you scored 6 out of a possible 6, in 29 turns.

Would you like to RESTART, RESTORE a saved game, QUIT or UNDO the last command?

>undo
sunporch
[Previous turn undone.]

>look
sunporch
It's an open-air porch that is bordered by the ocean, only steps away. Apparently you can do that in this part of the world.

On the far wall is a low, metal file cabinet, painted black, with three drawers. The fishtank is on it.

You can also see a wastebasket of salt water, a scallop shell and a conch shell here.

The hermit crab seems to be pining for the great outdoors.

>i
You are carrying:
  the fishtank of salt water
  a plastic castle
  a tiny shell
  a jar of fishfood (open but empty)

>score
You have so far scored 3 out of a possible 6, in 31 turns.

* * *

>open top
You open the top drawer of the black file cabinet, revealing an ancient candy bar and a jar of fishfood.

The hermit crab seems to stare at you accusingly.

>get candy bar
Taken.

>put candy bar in tank
The ancient candy bar doesn't go into liquids.

>feed candy bar to crab
The ancient candy bar doesn't go into liquids.

>open bottom
You open the lower drawer of the file cabinet, revealing some crab food, some paper and a pencil.

>get crab food
Taken.

>feed crab with crab food
You can't see any such thing.

>give crab food to crab
(the hermit crab)
As you shake the food on the water, the hermit crab seems to practically leap off its perch. The food quickly disappears.

>x tank
The fishtank is more than half full of salt water.

In the fishtank is a plastic castle.

>x castle
To no one's surprise -- not even the crab's -- it's a cheap plastic castle like everyone buys for their first fish tank.

On the plastic castle is a hermit crab.

>put scallop in tank
(first taking the scallop shell)
Once you drop it in, the hermit crab clambers over to inspect the scallop shell. It looks up in your direction, as if to say "what am I supposed to do with this flat thing?"  Then it climbs back to its place on the plastic castle.

>put conch in tank
(first taking the conch shell)
As soon as you get your hand out of the aquarium, the hermit crab clambers over to inspect the conch shell.  It leaves its own shell behind and scrambles in. After a long pause, it clambers back into its original shell. You could swear you saw it shake its tiny head.
 Then it climbs back to the top of the plastic castle.

>actions
Actions listing on.

>take plastic castle
[taking the plastic castle]
That's fixed in place.
[taking the plastic castle - failed the can't take what's fixed in place rule]

>showme castle
plastic castle - supporter
    hermit crab - animal
        tiny shell - shell
location: in the fishtank of salt water on the file cabinet in Den
singular-named, improper-named, unmarked for special listing; unlit, inedible, fixed in place, submersible; list grouping key: none
printed name: "plastic castle"
printed plural name: "supporters"
indefinite article: none
description: "To no one's surprise -- not even the crab's -- it's a cheap plastic castle like everyone buys for their first fish tank."
initial appearance: none
carrying capacity: 100

>take fishtank
[taking the fishtank of salt water]
It's got so much salt water in it that you will surely spill it.
[taking the fishtank of salt water - ended without result]

>actions off
Actions listing off.

* * *

>open top drawer
You open the upper drawer of the file cabinet, revealing a pencil.

The crab stares at you accusingly.

>open bottom drawer
You open the lower drawer of the file cabinet, revealing some paper.

The crab stares at you accusingly.

>x fishtank
The fishtank is about half full of salt water.

In the fishtank is a painted ceramic castle.

The crab stares at you accusingly.

* * *

>x castle
It's a cheap kind of castle everyone buys for their first fish tank.

On the painted ceramic castle is a hermit crab.

The crab stares at you accusingly.

>x crab
It's a hermit crab, looking like it's ready to upgrade to a new shell.

The crab stares at you accusingly.

* * *

>put scallop in tank
(first taking the scallop shell)
As soon as you get your hand out of the aquarium, the crab scuttles over to inspect the scallop shell. It looks up at you, as if to say "what am I supposed to do with this?"

>x crab
It's a small hermit crab. It looks annoyed. But maybe that's just a crab thing.

>put conch in tank
(first taking the conch shell)
As soon as you get your hand out of the aquarium, the crab scuttles over to inspect the conch shell.  It leaves its own shell behind and crawls in. After a moment, it crawls back into its original shell. You swear you see it shake its tiny head.

>put snail in tank
(first taking the snail shell)
As soon as you get your hand out of the aquarium, the crab scuttles over to inspect the snail shell.  It pauses, then rushes into the new shell, disappearing inside. After a moment, it pops its head out and crawls back to its perch on the castle, proudly sporting its new, larger shell.

>x crab
It's a small hermit crab. It looks annoyed. But maybe that's just a crab thing.

>x tiny
You see nothing special about the tiny shell.

>x tank
The fishtank is more than half full of salt water.

In the fishtank are a tiny shell, a conch shell, a scallop shell and a plastic castle.

* * *

>read book
You can't see any such thing.

>x drawers
You can't use multiple objects with that verb.

>open drawer
Which do you mean, the top, the middle or the bottom?

>open top
You open the top drawer of the black file cabinet, revealing a snail shell and a jar of fishfood.

The hermit crab seems hungry.

>open middle
You open the middle drawer of the black file cabinet, revealing an ancient candy bar.

>open bottom
You open the bottom drawer of the black file cabinet, revealing some paper and a pencil.

* * *

>rules
Rules tracing now switched on. Type "rules off" to switch it off again, or "rules all" to include even rules which do not apply.

* * *

>showme crab
crab - thing
location: in the fishtank of salt water in Den
singular-named, improper-named; unlit, inedible, portable, submersible
list grouping key: none
printed name: "crab"
printed plural name: none
indefinite article: none
description: none
initial appearance: none

* * *

>showme rock
rock - supporter
location: in the fishtank of salt water on the file cabinet in Den
singular-named, improper-named, unmarked for special listing; unlit, inedible, portable, unsubmersible; list grouping key: none
printed name: "rock"
printed plural name: "supporters"
indefinite article: none
description: none
initial appearance: none
carrying capacity: 100

>take tiny shell
That seems to belong to the hermit crab.

* * *

>showme tank
fishtank of salt water - fluid container
    plastic castle - supporter
        hermit crab - animal
location: on the file cabinet in Den
singular-named, improper-named, unmarked for special listing; unlit, inedible, portable, unsubmersible; opaque, open, unopenable, unlocked; list grouping key: none
printed name: "fishtank"
printed plural name: "fluid containers"
indefinite article: "the"
description: none
initial appearance: "It is a small, generic, rectangular fishtank, with a sandy bottom and a plastic castle. Sitting on the castle is a hermit crab."
carrying capacity: 100
fluid capacity: 10 gallons
fluid content: 6 gallons
liquid: salt water

>fill wastebasket from tank
(first taking the wastebasket)
You fill the wastebasket with salt water from the fishtank.

The crab stares at you accusingly.

>showme tank
fishtank of salt water - fluid container
    plastic castle - supporter
        hermit crab - animal
location: on the file cabinet in Den
singular-named, improper-named, unmarked for special listing; unlit, inedible, portable, unsubmersible; opaque, open, unopenable, unlocked; list grouping key: none
printed name: "fishtank"
printed plural name: "fluid containers"
indefinite article: "the"
description: none
initial appearance: "It is a small, generic, rectangular fishtank, with a sandy bottom and a plastic castle. Sitting on the castle is a hermit crab."
carrying capacity: 100
fluid capacity: 10 gallons
fluid content: 4 gallons
liquid: salt water

>take tank
Taken.

The crab stares at you accusingly.

>rules
Rules tracing now switched on. Type "rules off" to switch it off again, or "rules all" to include even rules which do not apply.

>pour out wastebasket
You can't see any such thing.

>pour wastebasket
[Rule "discourage mixing with liquid source rule" applies.]
[Rule "encourage mixing in glasses rule" applies.]
[Rule "encourage mixing in glasses rule" applies.]
What do you want to pour the wastebasket of salt water in?

>pour wastebasket in ocean
[Rule "declare everything initially unmentioned rule" applies.]
[Rule "setting liquid poured rule" applies.]
[Rule "setting liquid receiving rule" applies.]
[Rule "setting amount poured rule" applies.]
[Rule "announce items from multiple object lists rule" applies.]
[Rule "set pronouns from items from multiple object lists rule" applies.]
[Rule "before stage rule" applies.]
[Rule "instead stage rule" applies.]
[Rule "dumping fluids rule" applies.]
You dump out the wastebasket into the ocean.

[Rule "A first turn sequence rule" applies.]
[Rule "every turn stage rule" applies.]
[Rule "Every turn while the crab is visible" applies.]
The crab stares at you accusingly.

[Rule "A last turn sequence rule" applies.]
[Rule "notify score changes rule" applies.]

>x wastebasket
[Rule "declare everything initially unmentioned rule" applies.]
[Rule "announce items from multiple object lists rule" applies.]
[Rule "set pronouns from items from multiple object lists rule" applies.]
[Rule "before stage rule" applies.]
[Rule "can't act in the dark rule" applies.]
[Rule "instead stage rule" applies.]
[Rule "investigate player's awareness before action rule" applies.]
[Rule "player aware of his own actions rule" applies.]
[Rule "check stage rule" applies.]
[Rule "carry out stage rule" applies.]
[Rule "standard examining rule" applies.]
[Rule "examine directions rule" applies.]
[Rule "examining fluid containers rule" applies.]
The empty wastebasket contains only a trace of salt water at the bottom.

[Rule "examine containers rule" applies.]
[Rule "examine supporters rule" applies.]
[Rule "examine devices rule" applies.]
[Rule "examine undescribed things rule" applies.]
[Rule "after stage rule" applies.]
[Rule "investigate player's awareness after action rule" applies.]
[Rule "report stage rule" applies.]
[Rule "report other people examining rule" applies.]
[Rule "last specific action-processing rule" applies.]
[Rule "A first turn sequence rule" applies.]
[Rule "every turn stage rule" applies.]
[Rule "Every turn while the crab is visible" applies.]
The crab stares at you accusingly.

[Rule "A last turn sequence rule" applies.]
[Rule "notify score changes rule" applies.]

>fill wastebasket from tank
[Rule "declare everything initially unmentioned rule" applies.]
[Rule "announce items from multiple object lists rule" applies.]
[Rule "set pronouns from items from multiple object lists rule" applies.]
[Rule "before stage rule" applies.]
[Rule "instead stage rule" applies.]
[Rule "investigate player's awareness before action rule" applies.]
[Rule "player aware of his own actions rule" applies.]
[Rule "check stage rule" applies.]
[Rule "carry out stage rule" applies.]
[Rule "convert filling to pouring rule" applies.]
[Rule "setting liquid poured rule" applies.]
[Rule "setting liquid receiving rule" applies.]
[Rule "setting amount poured rule" applies.]
[Rule "announce items from multiple object lists rule" applies.]
[Rule "set pronouns from items from multiple object lists rule" applies.]
[Rule "before stage rule" applies.]
[Rule "instead stage rule" applies.]
[Rule "investigate player's awareness before action rule" applies.]
[Rule "player aware of his own actions rule" applies.]
[Rule "check stage rule" applies.]
[Rule "can't pour without fluid containers rule" applies.]
[Rule "might mix substances rule" applies.]
[Rule "carry out stage rule" applies.]
[Rule "standard carry out pouring rule" applies.]
[Rule "after stage rule" applies.]
[Rule "investigate player's awareness after action rule" applies.]
[Rule "report stage rule" applies.]
[Rule "standard report pouring rule" applies.]
You fill the wastebasket with salt water from the fishtank.
[Rule "last specific action-processing rule" applies.]

[Rule "after stage rule" applies.]
[Rule "investigate player's awareness after action rule" applies.]
[Rule "report stage rule" applies.]
[Rule "last specific action-processing rule" applies.]
[Rule "A first turn sequence rule" applies.]
[Rule "every turn stage rule" applies.]
[Rule "Every turn while the crab is visible" applies.]
The crab stares at you accusingly.

[Rule "A last turn sequence rule" applies.]
[Rule "notify score changes rule" applies.]

>pour wastebasket into tank
[Rule "declare everything initially unmentioned rule" applies.]
[Rule "setting liquid poured rule" applies.]
[Rule "setting liquid receiving rule" applies.]
[Rule "setting amount poured rule" applies.]
[Rule "announce items from multiple object lists rule" applies.]
[Rule "set pronouns from items from multiple object lists rule" applies.]
[Rule "before stage rule" applies.]
[Rule "instead stage rule" applies.]
[Rule "investigate player's awareness before action rule" applies.]
[Rule "player aware of his own actions rule" applies.]
[Rule "check stage rule" applies.]
[Rule "can't pour without fluid containers rule" applies.]
[Rule "might mix substances rule" applies.]
[Rule "carry out stage rule" applies.]
[Rule "standard carry out pouring rule" applies.]
[Rule "after stage rule" applies.]
[Rule "investigate player's awareness after action rule" applies.]
[Rule "report stage rule" applies.]
[Rule "standard report pouring rule" applies.]
You fill the fishtank with salt water from the wastebasket, leaving the wastebasket empty. It is about half full of salt water.

[Rule "last specific action-processing rule" applies.]
[Rule "A first turn sequence rule" applies.]
[Rule "every turn stage rule" applies.]
[Rule "Every turn while the crab is visible" applies.]
The crab stares at you accusingly.

[Rule "A last turn sequence rule" applies.]
[Rule "notify score changes rule" applies.]

>rules off
[Rule "declare everything initially unmentioned rule" applies.]
Rules tracing now switched off. Type "rules" to switch it on again.

>actions
Actions listing on.

>fill wastebasket from tank
[filling the empty wastebasket with the fishtank of salt water]
[(1) pouring the fishtank into the wastebasket]
You fill the wastebasket with salt water from the fishtank.
[(1) pouring the fishtank into the wastebasket - succeeded]

[filling the wastebasket of salt water with the fishtank of salt water - succeeded]

The crab stares at you accusingly.

* * *

>take castle
The crab lifts its tiny gripping claw in a wordless challenge, and you back off. Perhaps it needs something from you.

>give snail shell to crab
(first taking the snail shell)
Immediately, the hermit crab crawls over to inspect the snail shell.  It pauses, then rushes into the new shell, disappearing inside. After a moment, it pops its head out.
 Then it clambers back to the top of the plastic castle.

*** Run-time problem P10: Since the crab food is not allowed the property "comfortable", it is against the rules to try to use it.

* * *

>take crab
I don't suppose the hermit crab would care for that.

>rules
Rules tracing now switched on. Type "rules off" to switch it off again, or "rules all" to include even rules which do not apply.

>take crab
[Rule "declare everything initially unmentioned rule" applies.]
[Rule "announce items from multiple object lists rule" applies.]
[Rule "set pronouns from items from multiple object lists rule" applies.]
[Rule "before stage rule" applies.]
[Rule "instead stage rule" applies.]
[Rule "investigate player's awareness before action rule" applies.]
[Rule "player aware of his own actions rule" applies.]
[Rule "check stage rule" applies.]
[Rule "can't take yourself rule" applies.]
[Rule "can't take other people rule" applies.]
I don't suppose the hermit crab would care for that.

[Rule "A first turn sequence rule" applies.]
[Rule "every turn stage rule" applies.]
[Rule "Every turn while the hermit crab is visible" applies.]
The hermit crab seems to be wanting something.

[Rule "A last turn sequence rule" applies.]
[Rule "notify score changes rule" applies.]

* * *

>take fishtank
It's got so much liquid in it that you will surely spill it.

The crab stares at you accusingly.

>fill wastebasket
(first taking the wastebasket)
You fill the wastebasket up with salt water from the ocean.

The crab stares at you accusingly.

>drop wastebasket
Dropped.

The crab stares at you accusingly.

>get tank
It's got so much liquid in it that you will surely spill it.

The crab stares at you accusingly.

>empty wastebasket into ocean
You dump out the wastebasket into the ocean.

The crab stares at you accusingly.

>fill wastebasket
(first taking the wastebasket)
You fill the wastebasket with salt water from the fishtank.

The crab stares at you accusingly.

>l fishtank
The fishtank is about half full of salt water.

In the fishtank is a plastic castle.

The crab stares at you accusingly.

>drop wastebasket
Dropped.

The crab stares at you accusingly.

>i
You are carrying nothing.

The crab stares at you accusingly.

>take tank
Taken.

The crab stares at you accusingly.

>showme tank
fishtank of salt water - fluid container
    plastic castle - supporter
        hermit crab - animal
location: carried by yourself in Den
singular-named, improper-named, unmarked for special listing; unlit, inedible, portable, handled, unsubmersible; opaque, open, unopenable, unlocked; list grouping key: none
printed name: "fishtank"
printed plural name: "fluid containers"
indefinite article: "the"
description: none
initial appearance: "It is a small, generic, rectangular fishtank, with a sandy bottom and a plastic castle. Sitting on the castle is a hermit crab."
carrying capacity: 100
fluid capacity: 10 gallons
fluid content: 4 gallons
liquid: salt water

* * *

>take fishtank
It's got so much liquid in it that you will surely spill it.

The crab stares at you accusingly.

>showme fishtank
fishtank of salt water - fluid container
    plastic castle - supporter
        hermit crab - animal
location: carried by yourself in Den
singular-named, improper-named, unmarked for special listing; unlit, inedible, portable, handled, unsubmersible; opaque, open, unopenable, unlocked; list grouping key: none
printed name: "fishtank"
printed plural name: "fluid containers"
indefinite article: "the"
description: none
initial appearance: "It is a small, generic, rectangular fishtank, with a sandy bottom and a plastic castle. Sitting on the castle is a hermit crab."
carrying capacity: 100
fluid capacity: 10 gallons
fluid content: 6 gallons
liquid: salt water

>showme uncarriable weight
There seems to be no such object anywhere in the model world.

* * *

>take wastebasket
Taken.

>fill wastebasket from fishtank
You fill the wastebasket with salt water.

>look at fishtank
The fishtank is about half full of salt water.

>look at wastebasket
The wastebasket is full of salt water.

>pour wastebasket into the ocean
You dump out the wastebasket into the ocean.

>fill wastebasket from fishtank
You fill the wastebasket with salt water, leaving the fishtank empty. It is mostly full of salt water.

>look at wastebasket
The wastebasket is mostly full of salt water.

>look at fishtank
The empty fishtank contains only a trace of salt water at the bottom.

* * *

>take wastebasket
Taken.

>pour wastebasket into fishtank
The wastebasket is completely empty.

>fill wastebasket from fishtank
You pour salt water into the wastebasket.

* * *

>take wastebasket
Taken.

>rules
Rules tracing now switched on. Type "rules off" to switch it off again, or "rules all" to include even rules which do not apply.

>actions
[Rule "declare everything initially unmentioned rule" applies.]
Actions listing on.

>fill wastebasket from fishtank
[Rule "declare everything initially unmentioned rule" applies.]
[filling the empty wastebasket with the fishtank of salt water]
[Rule "announce items from multiple object lists rule" applies.]
[Rule "set pronouns from items from multiple object lists rule" applies.]
[Rule "before stage rule" applies.]
[Rule "instead stage rule" applies.]
[Rule "investigate player's awareness before action rule" applies.]
[Rule "player aware of his own actions rule" applies.]
[Rule "check stage rule" applies.]
[Rule "carry out stage rule" applies.]
[Rule "convert filling to pouring rule" applies.]
[Rule "setting liquid poured rule" applies.]
[Rule "setting liquid receiving rule" applies.]
[Rule "setting amount poured rule" applies.]
[(1) pouring the fishtank into the wastebasket]
[Rule "announce items from multiple object lists rule" applies.]
[Rule "set pronouns from items from multiple object lists rule" applies.]
[Rule "before stage rule" applies.]
[Rule "instead stage rule" applies.]
[Rule "investigate player's awareness before action rule" applies.]
[Rule "player aware of his own actions rule" applies.]
[Rule "check stage rule" applies.]
[Rule "can't pour without fluid containers rule" applies.]
[Rule "might mix substances rule" applies.]
[Rule "carry out stage rule" applies.]
[Rule "standard carry out pouring rule" applies.]
[Rule "after stage rule" applies.]
[Rule "investigate player's awareness after action rule" applies.]
[Rule "report stage rule" applies.]
[Rule "standard report pouring rule" applies.]
You fill the wastebasket with salt water from the fishtank.
[Rule "last specific action-processing rule" applies.]
[(1) pouring the fishtank into the wastebasket - succeeded]

[Rule "after stage rule" applies.]
[Rule "investigate player's awareness after action rule" applies.]
[Rule "report stage rule" applies.]
[Rule "last specific action-processing rule" applies.]
[filling the wastebasket of salt water with the fishtank of salt water - succeeded]

[Rule "A first turn sequence rule" applies.]
[Rule "every turn stage rule" applies.]
[Rule "A last turn sequence rule" applies.]
[Rule "notify score changes rule" applies.]

* * *

>test me
(Testing.)

>[1] x tank
The fishtank is more than half full of salt water.

In the fishtank is a plastic castle.

>[2] x crab
It's a small hermit crab wearing a tiny shell. It looks hungry. But maybe that's just the way crabs look.

The hermit crab seems to be wanting something.

>[3] take castle
The hermit crab lifts its tiny gripping claw in a wordless challenge, and you back off. Perhaps it needs something from you.

>[4] open top
You open the upper drawer of the file cabinet, revealing an ancient candy bar, some paper and a pencil.

>[5] open bottom
You open the lower drawer of the file cabinet, revealing a jar of fishfood.

The hermit crab seems to need attention.

>[6] take jar
Taken.

>[7] open jar
You open the jar of fishfood, revealing some fish flakes.

>[8] feed flakes to crab
(first taking the fish flakes)
As you shake the food on the water, the hermit crab seems to practically leap off its perch. The food quickly disappears and the crab scuttles back to its castle.

>[9] put conch in tank
(first taking the conch shell)
Soon, the hermit crab climbs over to inspect the conch shell.  It leaves its own shell behind and crawls in. After a long pause, it climbs back into its original shell. You could swear you saw it shake its tiny head.
 Then it scrambles back to its place on the plastic castle.

The hermit crab is hanging awkwardly onto its shell.

>[10] put snail in tank
(first taking the snail shell)
Immediately, the hermit crab climbs over to inspect the snail shell.  It pauses, then rushes into the new shell, disappearing inside. After a moment, it pops its head out. It already seems happier.
 Then it scuttles back to its home on the plastic castle.

The hermit crab appears to be gazing longingly toward the ocean.

>[11] fill can from tank
(first taking the wastebasket)
You fill the wastebasket with salt water from the fishtank.

>[12] pour can in ocean
You dump out the wastebasket into the ocean.

>[13] fill can from tank
You fill the wastebasket with salt water from the fishtank.

>[14] pour can in ocean
You dump out the wastebasket into the ocean.

>[15] take castle
The hermit crab politely chitters to the floor of the aquarium.

Taken.

The hermit crab seems wistful.

>[16] drop castle
Dropped.

The hermit crab appears to be gazing longingly toward the ocean.

>[17] take tank
Taken.

The hermit crab seems wistful.

>[18] pour tank in ocean
You dump out the fishtank into the ocean.

* * *

>x cabinet
It's a low, metal file cabinet with two drawers.

On the file cabinet is the fishtank (in which is a crab).

The file cabinet has two drawers. Neither are open.

>open top drawer
You open the upper drawer of the file cabinet.

>look
Den
It's a den that happens to open onto the ocean.

You can see a file cabinet (on which is the fishtank of salt water), the empty wastebasket and a book here.

>look in top drawer
The upper drawer is empty.

>x pencil
You can't see any such thing.

>open drawer
(the lower drawer of the file cabinet)
You open the lower drawer of the file cabinet.

>x lower
The lower drawer is empty.

>x upper
The upper drawer is empty.

>showall
That's not a verb I recognise.

>showme
Den - room
    yourself - person
    file cabinet - supporter
        upper drawer (part of file cabinet) - drawer
        lower drawer (part of file cabinet) - drawer
        fishtank of salt water - fluid container
            crab
    empty wastebasket - fluid container
    ocean - liquid lake
    book

>put book in bottom drawer
(first taking the book)
You put the book into the lower drawer.

>showme
Den - room
    yourself - person
    file cabinet - supporter
        upper drawer (part of file cabinet) - drawer
        lower drawer (part of file cabinet) - drawer
            book
        fishtank of salt water - fluid container
            crab
    empty wastebasket - fluid container
    ocean - liquid lake

>close drawers
You can't use multiple objects with that verb.

>close drawer
Which do you mean, the upper or the lower?

>close lowerdrawer
You can't see any such thing.

>close lower drawer
You close the lower drawer.

>close drawer
(the upper drawer of the file cabinet)
You close the upper drawer.

>i
You are carrying nothing.

>look
Den
It's a den that happens to open onto the ocean.

You can see a file cabinet (on which is the fishtank of salt water) and the empty wastebasket here.

>look at cabinet
It's a low, metal file cabinet with two drawers.

On the file cabinet is the fishtank (in which is a crab).

The file cabinet has two drawers. Neither are open.

>l bottom
You see nothing special about the lower drawer.

>open bottom
You open the lower drawer of the file cabinet, revealing a book.

* * *

>x conch
It's a large spiral conch shell. You put it to your ear for a moment and "hear the ocean".

* * *

>x crab
It's a small hermit crab wearing a tiny shell. It looks hungry. But maybe that's just the way crabs look.

>feed crab
What do you want to feed the hermit crab?

>actions
Actions listing on.

>feed crab
What do you want to feed the hermit crab?

>feed castle to crab
[giving the plastic castle to the hermit crab]
(first taking the plastic castle)
[(1) taking the plastic castle - silently]
That's fixed in place.
[(1) taking the plastic castle - silently - failed the can't take what's fixed in place rule]

[giving the plastic castle to the hermit crab - failed the carrying requirements rule]

* * *

>x crab
It's a small hermit crab wearing a tiny shell. It looks hungry. But maybe that's just the way crabs look.

>fill can
(first taking the wastebasket)
You fill the wastebasket up with salt water from the ocean.

The hermit crab seems to be wanting something.

>pour can into ocean
You dump out the wastebasket into the ocean.

>fill can from tank
You fill the wastebasket with salt water from the fishtank.

>pour can into ocean
You dump out the wastebasket into the ocean.

>get tank
It's going to be awkward to carry with the plastic castle in it.

>get castle
The hermit crab lifts its tiny gripping claw in a wordless challenge, and you back off. Perhaps it needs something from you.

The hermit crab seems to need attention.

>open drawer
Which do you mean, the upper or the lower?

>lower
You open the lower drawer of the file cabinet, revealing a pencil.

The hermit crab seems to stare at you accusingly.

>get food
You can't see any such thing.

>give food to crab
You can't see any such thing.

>open jar
You can't see any such thing.

>give food to crab
You can't see any such thing.

>x crab
It's a small hermit crab wearing a tiny shell. It looks hungry. But maybe that's just the way crabs look.

>look
Den
It's a den that happens to open onto the ocean.

It is a small, generic, rectangular fishtank, containing what looks like salt water, with a sandy bottom and a plastic castle. Sitting on the castle is a hermit crab.

On the far wall is a low, metal file cabinet, painted black, with two drawers. There's a fishtank on it.

You can also see a scallop shell, a conch shell, a snail shell and a book here.

>put scallop shell in tank
(first taking the scallop shell)
Soon, the hermit crab crawls over to inspect the scallop shell. It looks up in your direction, as if to say "what am I supposed to do with this flat thing?"  Then it climbs back to its place on the plastic castle.

The hermit crab seems hungry.

>get conch
Taken.

>put conch in tank
Immediately, the hermit crab chitters over to inspect the conch shell.  It leaves its own shell behind and scrambles in. After a long pause, it clambers back into its original shell. You could swear you saw it shake its tiny head.
 Then it climbs back to its home on the plastic castle.

>put snail in tank
(first taking the snail shell)
As soon as you get your hand out of the aquarium, the hermit crab clambers over to inspect the snail shell.  It pauses, then rushes into the new shell, disappearing inside. After a moment, it pops its head out. It already seems happier.
 Then it scrambles back to the top of the plastic castle.

>x
(the empty wastebasket)
It's a small plastic trash can.

The empty wastebasket contains only a trace of salt water at the bottom.

>x crab
It's a small hermit crab wearing a snail shell. It looks hungry. But maybe that's just the way crabs look.

The hermit crab still seems to stare at you accusingly.

>take tank
It's going to be awkward to carry with the plastic castle in it.

>get castle
The hermit crab lifts its tiny gripping claw in a wordless challenge, and you back off. Perhaps it needs something from you.

The hermit crab still seems hungry.

>take tank
It's going to be awkward to carry with the plastic castle in it.

>pour tank into ocean
You dump out the fishtank into the ocean.

>x tank
The empty fishtank contains only a trace of salt water at the bottom.

In the empty fishtank are a tiny shell, a snail shell, a conch shell, a scallop shell and a plastic castle.

The hermit crab still seems to be wanting something.

>showme tank
empty fishtank - fluid container
    tiny shell - shell
    snail shell - shell
    conch shell - shell
    scallop shell - shell
    plastic castle - supporter
        hermit crab - animal
location: on the file cabinet in Den
singular-named, improper-named, unmarked for special listing; unlit, inedible, portable, unsubmersible; opaque, open, unopenable, unlocked; list grouping key: none
printed name: "fishtank"
printed plural name: "fluid containers"
indefinite article: "the"
description: none
initial appearance: "It is a small, generic, rectangular fishtank, containing what looks like salt water, with a sandy bottom and a plastic castle. Sitting on the castle is a hermit crab."
carrying capacity: 100
fluid capacity: 10 gallons
fluid content: 0oz
liquid: salt water

>fill tank
(first taking the fishtank)
It's going to be awkward to carry with the plastic castle in it.

The hermit crab still seems to stare at you accusingly.

* * *

>x drawers
You can't use multiple objects with that verb.

>open drawer
Which do you mean, the upper or the lower?

>open upper drawer
You open the upper drawer of the file cabinet, revealing an ancient candy bar, some crab food, some paper and a pencil.

>look in drawer
Which do you mean, the upper or the lower?

>open lower drawer
You open the lower drawer of the file cabinet.

>look in lower drawer
The lower drawer is empty.

The crab seems hungry.

>look in upper drawer
In the upper drawer are an ancient candy bar, some crab food, some paper and a pencil.

The crab seems to need attention.

>x pencil
You see nothing special about the pencil.

The crab seems to stare at you accusingly.

>showme pencil
pencil - thing
location: in the upper drawer , which is part of the file cabinet in Den
singular-named, improper-named, unmarked for special listing; unlit, inedible, portable, unsubmersible
list grouping key: none
printed name: "pencil"
printed plural name: none
indefinite article: none
description: none
initial appearance: none

>x file cabinet
On the file cabinet is the fishtank (in which is a plastic castle (on which is a hermit crab)).

The file cabinet has two drawers. Both of them are open.

>showme file cabinet
file cabinet - supporter
    upper drawer (part of file cabinet) - drawer
    lower drawer (part of file cabinet) - drawer
        ancient candy bar
        crab food
        paper
        pencil
    fishtank of salt water - fluid container
        plastic castle - supporter
            hermit crab - animal
                tiny shell - shell
location: in Den
singular-named, improper-named, unmarked for special listing; unlit, inedible, fixed in place, unsubmersible; list grouping key: none
printed name: "file cabinet"
printed plural name: "supporters"
indefinite article: none
description: none
initial appearance: "On the far wall is a low, metal file cabinet, painted black, with two drawers. There's a fishtank on it."
carrying capacity: 100

>get food
Taken.

>feed crab
(the hermit crab the crab food)
Once you drop it in, the crab scuttles over to inspect the crab food. It looks up at you, as if to say "what am I supposed to do with this?"

>showverb feed
Verb 'feed' 'give' 'offer' 'pay' 
     * creature held -> Give reverse
     * held 'to' creature -> Give

* * *

>x fishtank
The fishtank is about half full of salt water.

In the fishtank is a painted ceramic castle.

The crab stares at you accusingly.

>pour fishtank into wastebasket
(first taking the fishtank)
You pour salt water into the wastebasket.

>look
Den
You can see the wastebasket of salt water here.

>i
You are carrying:
  the fishtank of salt water

>x fishtank
The fishtank is about half full of salt water.

>x wastebasket
The wastebasket is full of salt water.

>taste fishtank
It tastes like ocean water. You wouldn't want to drink much of it.

* * *

>x tank
The fishtank is more than half full of salt water.

In the fishtank is a plastic castle.

>take castle
Taken.

>drop castle
Dropped.

>take castle
Taken.

* * *

>drop castle
Dropped.

>rules
Rules tracing now switched on. Type "rules off" to switch it off again, or "rules all" to include even rules which do not apply.

>x castle
[Rule "declare everything initially unmentioned rule" applies.]
[Rule "announce items from multiple object lists rule" applies.]
[Rule "set pronouns from items from multiple object lists rule" applies.]
[Rule "before stage rule" applies.]
[Rule "can't act in the dark rule" applies.]
[Rule "instead stage rule" applies.]
[Rule "investigate player's awareness before action rule" applies.]
[Rule "player aware of his own actions rule" applies.]
[Rule "check stage rule" applies.]
[Rule "carry out stage rule" applies.]
[Rule "standard examining rule" applies.]
To no one's surprise -- not even the crab's -- it's a cheap plastic castle just like everyone buys for their first fish tank.

[Rule "examine directions rule" applies.]
[Rule "examining fluid containers rule" applies.]
[Rule "examine containers rule" applies.]
[Rule "examine supporters rule" applies.]
On the plastic castle is a hermit crab.

[Rule "examine devices rule" applies.]
[Rule "examine undescribed things rule" applies.]
[Rule "after stage rule" applies.]
[Rule "investigate player's awareness after action rule" applies.]
[Rule "report stage rule" applies.]
[Rule "report other people examining rule" applies.]
[Rule "last specific action-processing rule" applies.]
[Rule "A first turn sequence rule" applies.]
[Rule "every turn stage rule" applies.]
[Rule "A last turn sequence rule" applies.]
[Rule "notify score changes rule" applies.]

>actions
[Rule "declare everything initially unmentioned rule" applies.]
Actions listing on.

>take castle
[Rule "declare everything initially unmentioned rule" applies.]
[taking the plastic castle]
[Rule "announce items from multiple object lists rule" applies.]
[Rule "set pronouns from items from multiple object lists rule" applies.]
[Rule "before stage rule" applies.]
[Rule "Before taking the plastic castle" applies.]
[Rule "instead stage rule" applies.]
[Rule "investigate player's awareness before action rule" applies.]
[Rule "player aware of his own actions rule" applies.]
[Rule "check stage rule" applies.]
[Rule "can't take yourself rule" applies.]
[Rule "can't take other people rule" applies.]
[Rule "can't take component parts rule" applies.]
[Rule "can't take people's possessions rule" applies.]
[Rule "can't take items out of play rule" applies.]
[Rule "can't take what you're inside rule" applies.]
[Rule "can't take what's already taken rule" applies.]
[Rule "can't take scenery rule" applies.]
[Rule "can only take things rule" applies.]
[Rule "can't take what's fixed in place rule" applies.]
[Rule "use player's holdall to avoid exceeding carrying capacity rule" applies.]
[Rule "can't exceed carrying capacity rule" applies.]
[Rule "carry out stage rule" applies.]
[Rule "standard taking rule" applies.]
[Rule "after stage rule" applies.]
[Rule "investigate player's awareness after action rule" applies.]
[Rule "report stage rule" applies.]
[Rule "standard report taking rule" applies.]
Taken.
[Rule "last specific action-processing rule" applies.]
[taking the plastic castle - succeeded]

[Rule "A first turn sequence rule" applies.]
[Rule "every turn stage rule" applies.]
[Rule "A last turn sequence rule" applies.]
[Rule "notify score changes rule" applies.]

* * *

>x wastebasket
It's a small plastic trash can.

The empty wastebasket doesn't contain even a trace of liquid.

The crab stares at you accusingly.

>x wastebasket
It's a small plastic trash can.

The empty wastebasket doesn't contain even a trace of liquid.

The crab stares at you accusingly.

>rules
Rules tracing now switched on. Type "rules off" to switch it off again, or "rules all" to include even rules which do not apply.

>x wastebasket
[Rule "declare everything initially unmentioned rule" applies.]
[Rule "announce items from multiple object lists rule" applies.]
[Rule "set pronouns from items from multiple object lists rule" applies.]
[Rule "before stage rule" applies.]
[Rule "can't act in the dark rule" applies.]
[Rule "instead stage rule" applies.]
[Rule "investigate player's awareness before action rule" applies.]
[Rule "player aware of his own actions rule" applies.]
[Rule "check stage rule" applies.]
[Rule "carry out stage rule" applies.]
[Rule "standard examining rule" applies.]
It's a small plastic trash can.

[Rule "examine directions rule" applies.]
[Rule "examining fluid containers rule" applies.]
The empty wastebasket doesn't contain even a trace of liquid.

[Rule "examine containers rule" applies.]
[Rule "examine supporters rule" applies.]
[Rule "examine devices rule" applies.]
[Rule "examine undescribed things rule" applies.]
[Rule "after stage rule" applies.]
[Rule "investigate player's awareness after action rule" applies.]
[Rule "report stage rule" applies.]
[Rule "report other people examining rule" applies.]
[Rule "last specific action-processing rule" applies.]
[Rule "A first turn sequence rule" applies.]
[Rule "every turn stage rule" applies.]
[Rule "Every turn while the crab is visible" applies.]
The crab stares at you accusingly.

[Rule "A last turn sequence rule" applies.]
[Rule "notify score changes rule" applies.]

* * *

>rules off
[Rule "declare everything initially unmentioned rule" applies.]
Rules tracing now switched off. Type "rules" to switch it on again.

>i
You are carrying:
  a wastebasket of salt water

The crab stares at you accusingly.

>pour can into ocean
You dump out the wastebasket into the ocean.

The crab stares at you accusingly.

>fill can from tank
You fill the wastebasket with salt water from the fishtank.

The crab stares at you accusingly.

>pour can into ocean
You dump out the wastebasket into the ocean.

The crab stares at you accusingly.

>fill can from tank
You can't get any more salt water out of the tank with the empty wastebasket.

The crab stares at you accusingly.

>undo
Den
[Previous turn undone.]

>rules
Rules tracing now switched on. Type "rules off" to switch it off again, or "rules all" to include even rules which do not apply.

* * *

>actions
[Rule "declare everything initially unmentioned rule" applies.]
Actions listing on.

>fill can from tank
[Rule "declare everything initially unmentioned rule" applies.]
[filling the empty wastebasket with the fishtank of salt water]
[Rule "announce items from multiple object lists rule" applies.]
[Rule "set pronouns from items from multiple object lists rule" applies.]
[Rule "before stage rule" applies.]
[Rule "Before filling the wastebasket with the fishtank" applies.]
You can't get any more salt water out of the tank with the empty wastebasket.
[filling the empty wastebasket with the fishtank of salt water - ended without result]

[Rule "A first turn sequence rule" applies.]
[Rule "every turn stage rule" applies.]
[Rule "Every turn while the crab is visible" applies.]
The crab stares at you accusingly.

[Rule "A last turn sequence rule" applies.]
[Rule "notify score changes rule" applies.]

>undo
Den
[Previous turn undone.]

>undo
Den
[Previous turn undone.]