Nonmechanical Garden
An Interactive Fiction by Kent Quirk
Release 1 / Serial number 210310 / Inform 7 build 6M62 (I6/v6.34 lib 6/12N) SD

Garden
A white flagpole, which has rusted and been repainted many times, stands nearby.

You can also see an American flag here.

>get flag
Taken.

>hang flag
You put the American flag on the white pole.

The flag is on the pole.

>hang flag on pole
You put the American flag on the white pole.

The flag is on the pole.

>x pole
It's an old white flagpole with the American flag hanging limply near the bottom.

On the white pole is the American flag.

>raise
That's not a verb I recognise.

>lower
That's not a verb I recognise.

* * *

>hang flag
You put the American flag on the white pole.

The flag is on the pole.

>raise flag
You raise the flag to the top of the pole.

>hang flag
You aren't holding a flag!

* * *

>get flag
Taken.

>hang flag on pole
You put the American flag on the white pole.

The flag is on the pole.

>hang flag on flagpole
You can't see any such thing.

>x flagpole
You can't see any such thing.

>showme flagpole
There seems to be no such object anywhere in the model world.

>responses
>--> The following sets of responses are available:
    RESPONSES ALL
    RESPONSES 1: Standard Rules

>flagpole responses
That's not a verb I recognise.

>responses flagpole
>--> The following sets of responses are available:
    RESPONSES ALL
    RESPONSES 1: Standard Rules

>remove flag from flagpole
You can't see any such thing.

>hang flag on flagpole
You can't see any such thing.

* * *

>x flagpole
You can't see any such thing.

>x pole
It's a white flagpole the white pole with no flag white pole.

On the white pole is the American flag.

* * *

>get flag
Taken.

>put flag
What do you want to put the American flag in?

>pole
That can't contain things.

>put flag on pole
The American flag is on the white pole.

You put the American flag on the white pole.

>raise flag
You raise the flag to the top of the pole.

>x pole
It's an old white flagpole. An American flag is waving in the breeze at the top.

On the white pole is an American flag.

>rules
Rules tracing now switched on. Type "rules off" to switch it off again, or "rules all" to include even rules which do not apply.

>raise flag
[Rule "declare everything initially unmentioned rule" applies.]
[Rule "announce items from multiple object lists rule" applies.]
[Rule "set pronouns from items from multiple object lists rule" applies.]
[Rule "before stage rule" applies.]
[Rule "instead stage rule" applies.]
[Rule "investigate player's awareness before action rule" applies.]
[Rule "player aware of his own actions rule" applies.]
[Rule "check stage rule" applies.]
[Rule "Check flag-raising" applies.]
The flag is as high as it can go.

[Rule "A first turn sequence rule" applies.]
[Rule "every turn stage rule" applies.]
[Rule "A last turn sequence rule" applies.]
[Rule "notify score changes rule" applies.]

>show flag-raising rule
You can't see any such thing.

>showme flag-raising rule
There seems to be no such object anywhere in the model world.

>showme flag-raising
There seems to be no such object anywhere in the model world.

>showme checkflag-raising
There seems to be no such object anywhere in the model world.

>showme check flag-raising
There seems to be no such object anywhere in the model world.

>showme "Check flag-raising"
There seems to be no such object anywhere in the model world.

* * *

>get flag
Taken.

>raise flag
There is no flag on the pole to raise!

>put flag on pole
The American flag is on the white pole.

You put the American flag on the white pole.

>x pole
It's an old white flagpole. An American flag is hanging limply near the bottom.

On the white pole is an American flag.

>raise flag
There is no flag on the pole to raise!

>take flag
Taken.

>actions
Actions listing on.

>put flag
What do you want to put the American flag in?

>put flag on pole
[putting the American flag on the white pole]
The American flag is on the white pole.

You put the American flag on the white pole.
[putting the American flag on the white pole - succeeded]

>showme pole
white pole - flagpole
    American flag - hangableFlag
location: in the Garden
singular-named, improper-named; unlit, inedible, fixed in place; list grouping key: none
printed name: "white pole"
printed plural name: "flagpoles"
indefinite article: "the"
description: "It's an old white flagpole. An American flag is hanging limply near the bottom."
initial appearance: "A white flagpole, which has rusted and been repainted many times, stands nearby."
carrying capacity: 100
flagpole condition: fully-lowered

>showme flag
American flag - hangableFlag
location: on the white pole in the Garden
singular-named, improper-named; unlit, inedible, portable, handled
list grouping key: none
printed name: "American flag"
printed plural name: "hangableFlags"
indefinite article: none
description: none
initial appearance: none

>raise flag
[flag-raising the American flag]
There is no flag on the pole to raise!
[flag-raising the American flag - succeeded]

>rules
Rules tracing now switched on. Type "rules off" to switch it off again, or "rules all" to include even rules which do not apply.

>take flag
[Rule "declare everything initially unmentioned rule" applies.]
[taking the American flag]
[Rule "announce items from multiple object lists rule" applies.]
[Rule "set pronouns from items from multiple object lists rule" applies.]
[Rule "before stage rule" applies.]
[Rule "Before taking a hangableFlag when the noun is on a flagpole ( called fp )" applies.]
[Rule "instead stage rule" applies.]
[Rule "investigate player's awareness before action rule" applies.]
[Rule "player aware of his own actions rule" applies.]
[Rule "check stage rule" applies.]
[Rule "can't take yourself rule" applies.]
[Rule "can't take other people rule" applies.]
[Rule "can't take component parts rule" applies.]
[Rule "can't take people's possessions rule" applies.]
[Rule "can't take items out of play rule" applies.]
[Rule "can't take what you're inside rule" applies.]
[Rule "can't take what's already taken rule" applies.]
[Rule "can't take scenery rule" applies.]
[Rule "can only take things rule" applies.]
[Rule "can't take what's fixed in place rule" applies.]
[Rule "use player's holdall to avoid exceeding carrying capacity rule" applies.]
[Rule "can't exceed carrying capacity rule" applies.]
[Rule "carry out stage rule" applies.]
[Rule "standard taking rule" applies.]
[Rule "after stage rule" applies.]
[Rule "investigate player's awareness after action rule" applies.]
[Rule "report stage rule" applies.]
[Rule "standard report taking rule" applies.]
Taken.
[Rule "last specific action-processing rule" applies.]
[taking the American flag - succeeded]

[Rule "A first turn sequence rule" applies.]
[Rule "every turn stage rule" applies.]
[Rule "A last turn sequence rule" applies.]
[Rule "notify score changes rule" applies.]

>put flag on pole
[Rule "declare everything initially unmentioned rule" applies.]
[putting the American flag on the white pole]
[Rule "announce items from multiple object lists rule" applies.]
[Rule "set pronouns from items from multiple object lists rule" applies.]
[Rule "before stage rule" applies.]
[Rule "instead stage rule" applies.]
[Rule "investigate player's awareness before action rule" applies.]
[Rule "player aware of his own actions rule" applies.]
[Rule "check stage rule" applies.]
[Rule "convert put to drop where possible rule" applies.]
[Rule "can't put what's not held rule" applies.]
[Rule "can't put something on itself rule" applies.]
[Rule "can't put onto what's not a supporter rule" applies.]
[Rule "can't put clothes being worn rule" applies.]
[Rule "can't put if this exceeds carrying capacity rule" applies.]
[Rule "carry out stage rule" applies.]
[Rule "flag-putting rule" applies.]
The American flag is on the white pole.

[Rule "standard putting rule" applies.]
[Rule "after stage rule" applies.]
[Rule "investigate player's awareness after action rule" applies.]
[Rule "report stage rule" applies.]
[Rule "concise report putting rule" applies.]
[Rule "standard report putting rule" applies.]
You put the American flag on the white pole.
[Rule "last specific action-processing rule" applies.]
[putting the American flag on the white pole - succeeded]

[Rule "A first turn sequence rule" applies.]
[Rule "every turn stage rule" applies.]
[Rule "A last turn sequence rule" applies.]
[Rule "notify score changes rule" applies.]

>take flag
[Rule "declare everything initially unmentioned rule" applies.]
[taking the American flag]
[Rule "announce items from multiple object lists rule" applies.]
[Rule "set pronouns from items from multiple object lists rule" applies.]
[Rule "before stage rule" applies.]
[Rule "Before taking a hangableFlag when the noun is on a flagpole ( called fp )" applies.]
[Rule "instead stage rule" applies.]
[Rule "investigate player's awareness before action rule" applies.]
[Rule "player aware of his own actions rule" applies.]
[Rule "check stage rule" applies.]
[Rule "can't take yourself rule" applies.]
[Rule "can't take other people rule" applies.]
[Rule "can't take component parts rule" applies.]
[Rule "can't take people's possessions rule" applies.]
[Rule "can't take items out of play rule" applies.]
[Rule "can't take what you're inside rule" applies.]
[Rule "can't take what's already taken rule" applies.]
[Rule "can't take scenery rule" applies.]
[Rule "can only take things rule" applies.]
[Rule "can't take what's fixed in place rule" applies.]
[Rule "use player's holdall to avoid exceeding carrying capacity rule" applies.]
[Rule "can't exceed carrying capacity rule" applies.]
[Rule "carry out stage rule" applies.]
[Rule "standard taking rule" applies.]
[Rule "after stage rule" applies.]
[Rule "investigate player's awareness after action rule" applies.]
[Rule "report stage rule" applies.]
[Rule "standard report taking rule" applies.]
Taken.
[Rule "last specific action-processing rule" applies.]
[taking the American flag - succeeded]

[Rule "A first turn sequence rule" applies.]
[Rule "every turn stage rule" applies.]
[Rule "A last turn sequence rule" applies.]
[Rule "notify score changes rule" applies.]

>hang flag on pole
[Rule "declare everything initially unmentioned rule" applies.]
[flag-hanging the American flag]
[Rule "announce items from multiple object lists rule" applies.]
[Rule "set pronouns from items from multiple object lists rule" applies.]
[Rule "before stage rule" applies.]
[Rule "instead stage rule" applies.]
[Rule "investigate player's awareness before action rule" applies.]
[Rule "player aware of his own actions rule" applies.]
[Rule "check stage rule" applies.]
[Rule "Check flag-hanging" applies.]
[Rule "carry out stage rule" applies.]
[Rule "after stage rule" applies.]
[Rule "investigate player's awareness after action rule" applies.]
[Rule "report stage rule" applies.]
[Rule "last specific action-processing rule" applies.]
[flag-hanging the American flag - succeeded]

[Rule "A first turn sequence rule" applies.]
[Rule "every turn stage rule" applies.]
[Rule "A last turn sequence rule" applies.]
[Rule "notify score changes rule" applies.]

* * *

Nonmechanical Garden
An Interactive Fiction by Kent Quirk
Release 1 / Serial number 210310 / Inform 7 build 6M62 (I6/v6.34 lib 6/12N) SD

Garden
A white flagpole, which has rusted and been repainted many times, stands nearby.

You can also see an American flag here.

>get old
You can't see any such thing.

>hang old
You can't see any such thing.

>x pole
It's an old white flagpole. But there's no flag on it.
.

>raise flag
There is no flag on the pole to raise!

>raise Old Glory
You can't see any such thing.

>lower old
You can't see any such thing.

>raise flagpole
You can't see any such thing.

>raise pole
You can't see any such thing.

>lower
(the American flag)
The flag is as low as it can go.

>raise
(the American flag)
There is no flag on the pole to raise!

* * *

Nonmechanical Garden
An Interactive Fiction by Kent Quirk
Release 1 / Serial number 210310 / Inform 7 build 6M62 (I6/v6.34 lib 6/12N) SD

Garden
A white flagpole, which has rusted and been repainted many times, stands nearby.

You can also see an American flag here.

>hang flag
You aren't holding a flag!

>get flag
Taken.

* * *

>raise flag
You raise the flag to the top of the pole.

>lower flag
You lower the flag a bit. An American flag is fluttering proudly at half-mast.

>take flag
The flag is too high to reach.

>lower flag
You lower the flag a bit. An American flag is hanging limply near the bottom.

>take flag
Taken.

>hang flag
You put the American flag on the white pole.

The flag is on the pole.

>lower flag
The flag is as low as it can go.

>take flag
Taken.

>hang banana
It would be too disrespectful to hang that.

>hang flag
You put the American flag on the white pole.

The flag is on the pole.

* * *

>raise flag
You raise the flag to the top of the pole.

>raise banana
You can't raise that.

>raise flagpole
You can't see any such thing.

>raise pole
You raise a flag, not a flagpole.

* * *

>raise flag
You raise the flag to the top of the pole.

>raise flag
The flag is as high as it can go.

>take flag
The flag is too high to reach.

>hang flag
You aren't holding a flag!

>lower flag
You lower the flag a bit. An American flag is fluttering proudly at half-mast.

* * *

>take flag
Taken.

>put flag on pole
You put the American flag on the white pole.

>hang flag on pole
You aren't holding a flag!

>take flag
Taken.

>drop flag
Dropped.

* * *

>look
Garden
A white flagpole, which has rusted and been repainted many times, stands nearby.

You can also see an American flag here.

>x pole
It's an old white flagpole. But there's no flag on it.
.

* * *

Nonmechanical Garden
An Interactive Fiction by Kent Quirk
Release 1 / Serial number 210310 / Inform 7 build 6M62 (I6/v6.34 lib 6/12N) SD

Garden
A white flagpole, which has rusted and been repainted many times, stands nearby.

You can also see an American flag here.

>hang flag on pole
(first taking the American flag)
You put the American flag on the white pole.

The flag is on the pole.

>x pole
It's a white flagpole the white pole with a flag hanging limply near the bottom.

On the white pole is the American flag.

* * *

Nonmechanical Garden
An Interactive Fiction by Kent Quirk
Release 1 / Serial number 210310 / Inform 7 build 6M62 (I6/v6.34 lib 6/12N) SD

Garden
A white flagpole, which has rusted and been repainted many times, stands nearby.

You can also see an American flag here.

>look
Garden
A white flagpole, which has rusted and been repainted many times, stands nearby.

You can also see an American flag here.

>hang flag
You aren't holding a flag!

* * *

>get flag
Taken.

>raise flag
There is no flag on the white pole to raise!

>hang flag on pole
The American flag is on the white pole.

>x pole
It's an old white flagpole. An American flag is hanging limply near the bottom.

On the white pole is an American flag.

>raise flag
You raise the flag to the top of the pole.

* * *

>x pole
It's an old white flagpole. An American flag is waving in the breeze at the top.

On the white pole is an American flag.

>lower flag
You lower the flag a bit. An American flag is fluttering proudly at half-mast.

>x pole
It's an old white flagpole. An American flag is fluttering proudly at half-mast.

On the white pole is an American flag.

>lower flag
You lower the flag a bit. An American flag is hanging limply near the bottom.

>lower flag
The flag is as low as it can go.

>raise flag
You raise the flag to the top of the pole.

* * *

>raise flag
The flag is as high as it can go.

>x pole
It's an old white flagpole. An American flag is waving in the breeze at the top.

On the white pole is an American flag.

* * *

>hang flag
You aren't holding a flag!

>raise flag
There is no flag on the white pole to raise!

>get flag
Taken.

* * *

>raise flag
There is no flag on the white pole to raise!

>wave flag
It really needs a pole to wave from.

>hang flag on pole
That's not a verb I recognise.

>look
Garden
A white flagpole, which has rusted and been repainted many times, stands nearby.

>x pole
It's an old white flagpole. But there's no flag on it.
.

>x flag
You see nothing special about the American flag.

>showme flagpole
There seems to be no such object anywhere in the model world.

>showme pole
white pole - flagpole
location: in the Garden
singular-named, improper-named; unlit, inedible, fixed in place; list grouping key: none
printed name: "white pole"
printed plural name: "flagpoles"
indefinite article: "the"
description: "It's an old white flagpole. But there's no flag on it.
."
initial appearance: "A white flagpole, which has rusted and been repainted many times, stands nearby."
carrying capacity: 100
flagpole condition: fully-lowered

>showme flag
American flag - hangableFlag
location: carried by yourself in the Garden
singular-named, improper-named; unlit, inedible, portable, handled
list grouping key: none
printed name: "American flag"
printed plural name: "hangableFlags"
indefinite article: none
description: none
initial appearance: none

>i
You are carrying:
  an American flag
  a banana

>hang flag
That's not a verb I recognise.

>i
You are carrying:
  an American flag
  a banana

>raise flag
There is no flag on the white pole to raise!

* * *

>look
Garden
A white flagpole, which has rusted and been repainted many times, stands nearby.

You can also see an American flag here.

>x flagpole
It's a white flagpole with no flag. There are buttons on it.

>get flag
Taken.

>hang flag on flagpole
You put the American flag on the white flagpole.

The flagpole now has a flag hanging limply near the bottom.

* * *

Nonmechanical Garden
An Interactive Fiction by Kent Quirk
Release 1 / Serial number 210310 / Inform 7 build 6M62 (I6/v6.34 lib 6/12N) SD

Garden
A white flagpole, which has rusted and been repainted many times, stands nearby.

You can also see an American flag here.

>press up
You must name something more substantial.

>x flagpole
It's a white flagpole with no flag. There are buttons on it.

>x button
You can't see any such thing.

>x up button
I only understood you as far as wanting to examine up.

>press up button
You can't see any such thing.

>press down  button
You can't see any such thing.

>look
Garden
A white flagpole, which has rusted and been repainted many times, stands nearby. It has a white box with two buttons on it.

You can also see a stone bench here.

>x flagpole
It's a white flagpole with no flag. There are buttons on it.

* * *

Nonmechanical Garden
An Interactive Fiction by Kent Quirk
Release 1 / Serial number 210310 / Inform 7 build 6M62 (I6/v6.34 lib 6/12N) SD

Garden
A white flagpole, which has rusted and been repainted many times, stands nearby.

You can also see an American flag here.

>put flag on pole
The flagpole now has a flag hanging limply near the bottom.

>push up button
With an audible thunk, a motor comes to life and the flag creaks up the flagpole all the way to the top.

>push down
(the down button)
You hear the hum of a motor, and the flag moves down a bit. The flagpole has a flag fluttering proudly fat half-mast in honor of Uncle Rob and his service to America.

* * *

Nonmechanical Garden
An Interactive Fiction by Kent Quirk
Release 1 / Serial number 210310 / Inform 7 build 6M62 (I6/v6.34 lib 6/12N) SD

Garden
A white flagpole, which has rusted and been repainted many times, stands nearby.

You can also see an American flag here.

>take flag
Taken.

>put flag
What do you want to put the American flag in?

>i
You are carrying:
  an American flag
  a banana

>look
Garden
A white flagpole, which has rusted and been repainted many times, stands nearby.

>put flag on pole
You put the American flag on the white pole.

>east
The Backyard

>put flag on pole
You can't see any such thing.

>i
You are carrying:
  a banana

>put flag
You can't see any such thing.

>w
Garden
A white flagpole, which has rusted and been repainted many times, stands nearby.

On the white pole is an American flag.

>west
You can't go that way.

>rules
Rules tracing now switched on. Type "rules off" to switch it off again, or "rules all" to include even rules which do not apply.

>put flag
(in the banana)
[Rule "declare everything initially unmentioned rule" applies.]
[Rule "announce items from multiple object lists rule" applies.]
[Rule "set pronouns from items from multiple object lists rule" applies.]
[Rule "before stage rule" applies.]
[Rule "instead stage rule" applies.]
[Rule "investigate player's awareness before action rule" applies.]
[Rule "player aware of his own actions rule" applies.]
[Rule "check stage rule" applies.]
[Rule "convert insert to drop where possible rule" applies.]
[Rule "can't insert what's not held rule" applies.]
[Rule "Rule for implicitly taking a hangableFlag" applies.]
[Rule "A first turn sequence rule" applies.]
[Rule "every turn stage rule" applies.]
[Rule "A last turn sequence rule" applies.]
[Rule "notify score changes rule" applies.]

>i
[Rule "declare everything initially unmentioned rule" applies.]
[Rule "announce items from multiple object lists rule" applies.]
[Rule "set pronouns from items from multiple object lists rule" applies.]
[Rule "before stage rule" applies.]
[Rule "instead stage rule" applies.]
[Rule "investigate player's awareness before action rule" applies.]
[Rule "player aware of his own actions rule" applies.]
[Rule "check stage rule" applies.]
[Rule "carry out stage rule" applies.]
[Rule "print empty inventory rule" applies.]
[Rule "print standard inventory rule" applies.]
You are carrying:
  a banana
[Rule "after stage rule" applies.]
[Rule "investigate player's awareness after action rule" applies.]
[Rule "report stage rule" applies.]

[Rule "report other people taking inventory rule" applies.]
[Rule "last specific action-processing rule" applies.]
[Rule "A first turn sequence rule" applies.]
[Rule "every turn stage rule" applies.]
[Rule "A last turn sequence rule" applies.]
[Rule "notify score changes rule" applies.]

>put flag on flagpole
You can't see any such thing.

>put flag on pole
[Rule "declare everything initially unmentioned rule" applies.]
[Rule "announce items from multiple object lists rule" applies.]
[Rule "set pronouns from items from multiple object lists rule" applies.]
[Rule "before stage rule" applies.]
[Rule "instead stage rule" applies.]
[Rule "investigate player's awareness before action rule" applies.]
[Rule "player aware of his own actions rule" applies.]
[Rule "check stage rule" applies.]
[Rule "convert put to drop where possible rule" applies.]
[Rule "can't put what's not held rule" applies.]
[Rule "Rule for implicitly taking a hangableFlag" applies.]
[Rule "A first turn sequence rule" applies.]
[Rule "every turn stage rule" applies.]
[Rule "A last turn sequence rule" applies.]
[Rule "notify score changes rule" applies.]

* * *

Nonmechanical Garden
An Interactive Fiction by Kent Quirk
Release 1 / Serial number 210310 / Inform 7 build 6M62 (I6/v6.34 lib 6/12N) SD

Garden
A white flagpole, which has rusted and been repainted many times, stands nearby.

You can also see an American flag here.

>test me
(Testing.)

>[1] put flag on flagpole
>[2] get flag
Taken.

>[3] put flag on flagpole
You put the American flag on the white flagpole.

>[4] lower flag
The flag is as low as it can go.

>[5] raise flag
You raise the flag to the top of the pole.

>[6] take flag
The flag is too high to reach.

>[7] lower flag
You lower the flag a bit. An American flag is fluttering proudly at half-mast.

>[8] x flagpole
It's an old white flagpole. An American flag is fluttering proudly at half-mast.

On the white flagpole is an American flag.

>[9] take flag
The flag is too high to reach.

>[10] lower flag
You lower the flag a bit. An American flag is hanging limply near the bottom.

>[11] x flagpole
It's an old white flagpole. An American flag is hanging limply near the bottom.

On the white flagpole is an American flag.

>[12] take flag
Taken.

>[13] raise flag
There is no flag on the white flagpole to raise!

>[14] hang flag
The American flag is on the white flagpole.

>[15] raise flag
You raise the flag to the top of the pole.

>lower flag
You lower the flag a bit. An American flag is fluttering proudly at half-mast.

* * *

>push up
(the up button)
You hear a brief buzz but nothing else happens.

>push down
(the down button)
There is just a click.

>push up
(the up button)
You hear a brief buzz but nothing else happens.

>x pole
It's a white flagpole with a flag waving in the breeze at the top. It has a white box with two buttons on it.

>get flag
The flag is too high to reach.

You already have that.

>x pole
It's a white flagpole with a flag waving in the breeze at the top. It has a white box with two buttons on it.

* * *

>x polke
You can't see any such thing.

>x pole
It's a white flagpole with a flag waving in the breeze at the top. There are buttons on it.

On the flagpole is a flag.

>x box
The flagpole's rope enters a white metal box with two buttons.

>x up
(the up button)
It's a black plastic button with the word Up etched into it. The etching was once filled with white paint, but that's mostly gone now.

>press up
(the up button)
You hear a brief buzz but nothing else happens.

>x up
(the up button)
It's a black plastic button with the word Up etched into it. The etching was once filled with white paint, but that's mostly gone now.

>x buttons
It's a black plastic button with the word Up etched into it. The etching was once filled with white paint, but that's mostly gone now.

>x button
Which do you mean, the up button or the down button?

>up
It's a black plastic button with the word Up etched into it. The etching was once filled with white paint, but that's mostly gone now.

>x box
The flagpole's rope enters a white metal box with two buttons.

>get buttons
That seems to be a part of the white box.

* * *

Nonmechanical Garden
An Interactive Fiction by Kent Quirk
Release 1 / Serial number 210310 / Inform 7 build 6M62 (I6/v6.34 lib 6/12N) SD

Garden
A white flagpole, which has rusted and been repainted many times, stands nearby.

You can also see an American flag here.

>x bench
From this restful location you get a nice view of the harbor.

>sit on bench
You get onto the stone bench.

>stand
You get off the stone bench.

Garden
A white flagpole, which has rusted and been repainted many times, stands in the center of the garden. 

You can also see a stone bench here.

>sit on bench
You get onto the stone bench.

>look
Garden (on the stone bench)
A white flagpole, which has rusted and been repainted many times, stands in the center of the garden.

>x bench
From this restful location you get a nice view of the harbor.

>x harbor
Beyond the beach, the harbor stretches off to the south, filled with boats, lobster pots, and seagulls.

>i
You are carrying:
  a flag
  an oyster

>put oyster on flagpole
It would be disrespectful to hang the oyster from the flagpole.

>put flag on flagpole
The flagpole now has a flag hanging limply near the bottom.

>raise flag
That's not a verb I recognise.

>raise flag to top
That's not a verb I recognise.

>raise flag flag
That's not a verb I recognise.

>raise flag flagpole
That's not a verb I recognise.

>get flag
Taken.

>put flag on flagpole
The flagpole now has a flag hanging limply near the bottom.

>remove flat from flagpole
You can't see any such thing.

>remove flag from flagpole
Taken.

>x flagpole
It's a white flagpole a flag hanging limply near the bottom.
.

* * *

Nonmechanical Garden
An Interactive Fiction by Kent Quirk
Release 1 / Serial number 210310 / Inform 7 build 6M62 (I6/v6.34 lib 6/12N) SD

Garden
A white flagpole, which has rusted and been repainted many times, stands nearby.

You can also see an American flag here.

>x flagpole
It's a white flagpole with no flag. There are buttons on it.

>x buttons
You can't see any such thing.

>push up button
You can't see any such thing.

>x buttons
You can't see any such thing.

>x up
You see nothing unexpected in that direction.

>x up button
I only understood you as far as wanting to examine up.

>x box
You can't see any such thing.